GACCTGTTAGT -> ACCTGTTAGTT
GCACGAGTGGT -> CACGAGTGGTA
GGACTCGCGAC -> GACTCGCGACG
GTATAGAACGC -> TATAGAACGCC
CAGCTAACTAA -> AGCTAACTAAT
AATTGCCGCGG -> ATTGCCGCGGA
CGTAATACGCT -> GTAATACGCTG
GACAGAAAAAT -> ACAGAAAAATC
ACGGCTCAAGG -> CGGCTCAAGGT
CCGCGACCTGT -> CGCGACCTGTT
AGCGTTCTGGC -> GCGTTCTGGCT
CGAGAGAATCC -> GAGAGAATCCA
TATGGAGGCAA -> ATGGAGGCAAG
GCGGAGTTAGG -> CGGAGTTAGGC
GATGGGACCGG -> ATGGGACCGGT
TCAAGGTCGCG -> CAAGGTCGCGG
ACGCGGAGTTA -> CGCGGAGTTAG
ACATCCCTCAG -> CATCCCTCAGA
AAAATCACTGA -> AAATCACTGAG
CAATTAAGGGC -> AATTAAGGGCA
CTCGCTGTTGC -> TCGCTGTTGCA
TGGGTTTTCGT -> GGGTTTTCGTA
AGGGCTAGCTT -> GGGCTAGCTTG
TTGGGATCGGC -> TGGGATCGGCG
AGTTAGCCCAG -> GTTAGCCCAGC
GTGGACATACG -> TGGACATACGT
AGAACGCCTAC -> GAACGCCTACG
TTGTTCCGTAC -> TGTTCCGTACA
ATACATACAGA -> TACATACAGAT
ATGTTTTAGAG -> TGTTTTAGAGT
GTAATGCAACT -> TAATGCAACTT
ATCCCCGCGAG -> TCCCCGCGAGT
CAAGCGTATGA -> AAGCGTATGAC
ATGGTTGGGGC -> TGGTTGGGGCT
CTGCAACATAC -> TGCAACATACC
GCGGGACTCGC -> CGGGACTCGCG
GTATGACCCGC -> TATGACCCGCG
TAATGCAACTT -> AATGCAACTTT
TAAAGAATTGC -> AAAGAATTGCC
CTAACTAATCT -> TAACTAATCTA
CAACCTTGTTT -> AACCTTGTTTT
TTTGAGTGGAC -> TTGAGTGGACA
TTTAGGGATCC -> TTAGGGATCCA
GTGTGCAAACA -> TGTGCAAACAA
CGAGGCATGTT -> GAGGCATGTTT
ATTCTTCTCGG -> TTCTTCTCGGT
CCCTCAGACGT -> CCTCAGACGTC
GGAGTGGGGTA -> GAGTGGGGTAT
TTAGCTTGATG -> TAGCTTGATGG
TAATCTATTGC -> AATCTATTGCG
CATAGACGGCT -> ATAGACGGCTC
GGGGCATTTCA -> GGGCATTTCAC
GCACGCGGAGT -> CACGCGGAGTT
ATGTCGGCTTG -> TGTCGGCTTGG
CCAGTAGCAGC -> CAGTAGCAGCC
GCCTGGGCCGG -> CCTGGGCCGGC
AAGAATTGCCG -> AGAATTGCCGC
GAAAATCACTG -> AAAATCACTGA
GCCGTCTCAGT -> CCGTCTCAGTG
TGCTCCCAAGC -> GCTCCCAAGCG
GCGACGACCTA -> CGACGACCTAT
CCATCTTCAAC -> CATCTTCAACT
GCGTATGACCC -> CGTATGACCCG
TTGTTCACTGT -> TGTTCACTGTT
GCGTTCTGGCT -> CGTTCTGGCTT
TACCAATCTCG -> ACCAATCTCGC
AACAGGATTGC -> ACAGGATTGCA
TACGGGGTCAA -> ACGGGGTCAAG
TTATTTCCTTC -> TATTTCCTTCA
TGACGCATGCC -> GACGCATGCCG
GTCCGGAAAAA -> TCCGGAAAAAG
CTCAGTGTATT -> TCAGTGTATTG
GTCTAACCCCC -> TCTAACCCCCA
ACCCATCTTCA -> CCCATCTTCAA
TATAGCGGGAC -> ATAGCGGGACT
CGCGTGCCTTT -> GCGTGCCTTTC
TTGCGGAAACT -> TGCGGAAACTC
TTAAGGGCAAG -> TAAGGGCAAGT
TGCCGTATGCA -> GCCGTATGCAT
GAAACTCGAGG -> AAACTCGAGGC
ACGTGGGGGTA -> CGTGGGGGTAT
GCAACATACCG -> CAACATACCGT
GGCTTGGCGCC -> GCTTGGCGCCA
TATAGAACGCC -> ATAGAACGCCT
GTGCCTTTCCT -> TGCCTTTCCTC
TTTGTCCCTGG -> TTGTCCCTGGC
TCAGTCAGTCG -> CAGTCAGTCGG
TGTTGACGCAT -> GTTGACGCATG
TGGCCCGGTCC -> GGCCCGGTCCC
ACGTCCTCGCT -> CGTCCTCGCTC
GGGCACTGTTG -> GGCACTGTTGC
GTTAGCCCAGC -> TTAGCCCAGCT
ATTTCCCGATA -> TTTCCCGATAG
TAACTCAGGTG -> AACTCAGGTGG
AGCCAGCAATC -> GCCAGCAATCC
TTTGGCATACC -> TTGGCATACCC
TTAGTAATGCA -> TAGTAATGCAA
CGACGACCTAT -> GACGACCTATT
CGTTAACGAGA -> GTTAACGAGAC
CCCGATAGCGA -> CCGATAGCGAC
CTCTAACCAGG -> TCTAACCAGGC
CACAGGTCTTA -> ACAGGTCTTAG
TCGCTGTTGCA -> CGCTGTTGCAT
GAGCCACTGAA -> AGCCACTGAAG
TTCGGTTTCTA -> TCGGTTTCTAA
GGGGTATGGAG -> GGGTATGGAGG
AAAGACCTCCG -> AAGACCTCCGA
TGTTTTGGCAT -> GTTTTGGCATA
CAAAGCGGCTC -> AAAGCGGCTCG
CAGGTCTTAGC -> AGGTCTTAGCT
AAAAAGGGTGA -> AAAAGGGTGAG
GAGTGGACATA -> AGTGGACATAC
TTCTTGGCCAT -> TCTTGGCCATT
GGTGAGGGTAT -> GTGAGGGTATA
TTACGGTCCGG -> TACGGTCCGGA
AGTCTCTCTGA -> GTCTCTCTGAG
GTGCTGTTCAT -> TGCTGTTCATT
AGCATTTCCCG -> GCATTTCCCGA
TGCGTCCATAG -> GCGTCCATAGA
ACGTCATGGCG -> CGTCATGGCGT
CATACCCCACT -> ATACCCCACTA
CGATATTGGCC -> GATATTGGCCC
CTTGGCGCCAT -> TTGGCGCCATT
TTTGCTGCGCG -> TTGCTGCGCGT
CAACTTACGGT -> AACTTACGGTC
TAACCAGGCAC -> AACCAGGCACT
CATAATGGTTG -> ATAATGGTTGG
CTAACCCCCAT -> TAACCCCCATT
GCAAAGCAGAT -> CAAAGCAGATA
GCACGTAATTG -> CACGTAATTGG
GGACCTACCAA -> GACCTACCAAT
GGGACCGGTTT -> GGACCGGTTTG
ACTTGGGATCG -> CTTGGGATCGG
GCAAATTTTGC -> CAAATTTTGCG
ACCTCCGAGTG -> CCTCCGAGTGC
AGATGGGACCG -> GATGGGACCGG
CCTAAAGGGTC -> CTAAAGGGTCC
ACGACCTCCTA -> CGACCTCCTAA
TAGCACGAGAA -> AGCACGAGAAA
GTCAGTCAGTC -> TCAGTCAGTCG
TTTAGAGATGT -> TTAGAGATGTT
CCTGTTAGTTT -> CTGTTAGTTTG
GAGGCATGTTT -> AGGCATGTTTA
TAGAGATGTTT -> AGAGATGTTTT
TTTTTGAGTGG -> TTTTGAGTGGA
CGCATACCCCC -> GCATACCCCCG
CTCGCTCTGTG -> TCGCTCTGTGT
CTGATAAGACT -> TGATAAGACTG
CGCGACGGTTC -> GCGACGGTTCA
CAATTCCGTGG -> AATTCCGTGGG
GGAACACAATT -> GAACACAATTC
GTCTGAAGCAC -> TCTGAAGCACT
GTGCCGAGAGA -> TGCCGAGAGAA
TGTTGCATTCA -> GTTGCATTCAC
TATTTTTGCTG -> ATTTTTGCTGC
ACTGTTGACGC -> CTGTTGACGCA
GTTTGGAAGTT -> TTTGGAAGTTT
AACGCCTACGT -> ACGCCTACGTG
TTCACAGATGC -> TCACAGATGCG
CACTTGGGATC -> ACTTGGGATCG
TGAGGGTATAG -> GAGGGTATAGA
GGACGAGCGCA -> GACGAGCGCAG
TGGCTTGCTCC -> GGCTTGCTCCC
GTCGGCTTGGC -> TCGGCTTGGCG
CTGGAGTGGGG -> TGGAGTGGGGT
TACAGTATTTC -> ACAGTATTTCG
CGGCCGGTGCG -> GGCCGGTGCGA
TTACCTAGTTA -> TACCTAGTTAG
GATCACATTTC -> ATCACATTTCG
ACCAGGAGTAT -> CCAGGAGTATT
ATGTTTAGGGA -> TGTTTAGGGAT
CTTGGGATCGG -> TTGGGATCGGC
TCAGACGTCAG -> CAGACGTCAGA
TCCTCGCTCTG -> CCTCGCTCTGT
ATCCAGAGGCT -> TCCAGAGGCTC
CGAAAGACCTC -> GAAAGACCTCC
CATTCGGTTTC -> ATTCGGTTTCT
CATTGGGAACA -> ATTGGGAACAC
TCTCAGTGGAC -> CTCAGTGGACC
TTCATCGAGCC -> TCATCGAGCCA
CTGAGTTAGGG -> TGAGTTAGGGC
CGGAAACTCGA -> GGAAACTCGAG
TAAGGGCAAGT -> AAGGGCAAGTG
GAGTTCGGACT -> AGTTCGGACTT
TGATTACGACC -> GATTACGACCT
GCTGTTGCATT -> CTGTTGCATTC
AAATCGTCTGG -> AATCGTCTGGA
AACTAATCTAT -> ACTAATCTATT
TTCACCACGGG -> TCACCACGGGA
AGCGGCGCAAA -> GCGGCGCAAAG
CGATTGTTCAC -> GATTGTTCACT
GGCGCAAATCT -> GCGCAAATCTA
AGAGTTCGGAC -> GAGTTCGGACT
GGTATCGTTAA -> GTATCGTTAAC
AAAGGGTCGGC -> AAGGGTCGGCG
ATACCGTACAC -> TACCGTACACG
TATGAACTGAT -> ATGAACTGATA
TCGGTTTGTCA -> CGGTTTGTCAC
CCTACTCGCAT -> CTACTCGCATA
CTGATGGCTTT -> TGATGGCTTTT
ATGATTACGAC -> TGATTACGACC
CCCTGGCATAG -> CCTGGCATAGT
GGGACAAACTT -> GGACAAACTTC
TGCGGAAACTC -> GCGGAAACTCG
GAATGTCGGCT -> AATGTCGGCTT
ACATACAGATG -> CATACAGATGG
TTTTTGCTGCG -> TTTTGCTGCGC
TACCGTACACG -> ACCGTACACGC
GGGGCTCAGTG -> GGGCTCAGTGT
TACGTTCGGTA -> ACGTTCGGTAC
GCAAATCTATA -> CAAATCTATAG
TCTAACCAGGC -> CTAACCAGGCA
TATTGGAGAGC -> ATTGGAGAGCA
TTTCCTTCATC -> TTCCTTCATCG
AGCGACGACCT -> GCGACGACCTA
AGCGGCTCGCT -> GCGGCTCGCTG
CGGTTTGTCAC -> GGTTTGTCACA
AGCGCAGATCG -> GCGCAGATCGT
GACTGATGGCT -> ACTGATGGCTT
GGCTCAGTGTA -> GCTCAGTGTAT
ACTGGCTAACT -> CTGGCTAACTC
GTTTGTCACAT -> TTTGTCACATA
CCAATTAGCTT -> CAATTAGCTTG
GTCTCTCTGAG -> TCTCTCTGAGC
TGGTCGCATGT -> GGTCGCATGTC
GCAAGCGTATG -> CAAGCGTATGA
GTATTGCAAGC -> TATTGCAAGCG
TAGTTTTGGTC -> AGTTTTGGTCG
CTGAAGTTCTA -> TGAAGTTCTAG
GATTACGACCT -> ATTACGACCTC
ACGAGAAAATC -> CGAGAAAATCA
TATGTCGGTAT -> ATGTCGGTATG
AAGAATGTCGG -> AGAATGTCGGC
TCTGAAGCACT -> CTGAAGCACTC
TCTGGAGTGGG -> CTGGAGTGGGG
GTCTACAATTA -> TCTACAATTAT
TCGCGGGGCAT -> CGCGGGGCATT
GAACTGATAAG -> AACTGATAAGA
CTCCAGCTAAC -> TCCAGCTAACT
TTTACAGTATT -> TTACAGTATTT
ACCTAGTTAGC -> CCTAGTTAGCC
GCATACCCCAC -> CATACCCCACT
GCGTCCATAGA -> CGTCCATAGAT
CCCCTTCAGAG -> CCCTTCAGAGT
TCCCAAGCGGC -> CCCAAGCGGCG
ATCACTGAGCA -> TCACTGAGCAA
TGCGCGTACAT -> GCGCGTACATC
GTTCTAGCGTT -> TTCTAGCGTTC
TGACCCGCGTG -> GACCCGCGTGC
CATAGGACCTA -> ATAGGACCTAC
AGCTAACTAAT -> GCTAACTAATC
CGGTCCGGAAA -> GGTCCGGAAAA
CAGGAGTATTG -> AGGAGTATTGT
CGGCGAGAGTG -> GGCGAGAGTGG
GATTGTTCACT -> ATTGTTCACTG
AACCCCCATTC -> ACCCCCATTCG
TCGATTCGAGT -> CGATTCGAGTT
TTTTTTATGTC -> TTTTTATGTCG
ACAGATGCGTC -> CAGATGCGTCC
AGTTCTAGCGT -> GTTCTAGCGTT
AAGTGAAGCCT -> AGTGAAGCCTT
TCAGTGTATTG -> CAGTGTATTGC
CACGTCCTCGC -> ACGTCCTCGCT
GCTTGATGGCC -> CTTGATGGCCA
TTGGCCATTCT -> TGGCCATTCTT
ACGGCGAGAGT -> CGGCGAGAGTG
AGGGTGAGGGT -> GGGTGAGGGTA
TACGGTCCGGA -> ACGGTCCGGAA
CTAAAGGGTCC -> TAAAGGGTCCT
GGACAAACTTC -> GACAAACTTCC
CATGTCGGCAA -> ATGTCGGCAAA
GCTCAAGGTCG -> CTCAAGGTCGC
GAGTTTAGCAC -> AGTTTAGCACG
GCACTGTCCAG -> CACTGTCCAGT
GGGTTTTCGTA -> GGTTTTCGTAA
ACAATTCCGTG -> CAATTCCGTGG
TCACGGCATTG -> CACGGCATTGC
CATTTCGCAAA -> ATTTCGCAAAG
CTATTGCGGAA -> TATTGCGGAAA
GGGAAAGCAAC -> GGAAAGCAACC
GCGGAAACTCG -> CGGAAACTCGA
CTTCAGTTGCG -> TTCAGTTGCGG
CGACCTGTTAG -> GACCTGTTAGT
GCCCAGCTCTA -> CCCAGCTCTAA
CGGGGCACGCG -> GGGGCACGCGG
GCATTTCACCA -> CATTTCACCAC
CTAGCTTGCTG -> TAGCTTGCTGC
TGTCCCTGGCA -> GTCCCTGGCAT
TCGTCTACAAT -> CGTCTACAATT
CCACGGGAAAG -> CACGGGAAAGC
ACAAACTTCCT -> CAAACTTCCTA
GGTATGTCTGG -> GTATGTCTGGT
CCGGCGAAAGA -> CGGCGAAAGAC
GTTTGTTCCGT -> TTTGTTCCGTA
TGCAAACAAAC -> GCAAACAAACT
CGGAAAAAGGG -> GGAAAAAGGGT
TTGTGCCGTCT -> TGTGCCGTCTC
GGCTTTTTTTT -> GCTTTTTTTTA
CGCGGAGCATT -> GCGGAGCATTT
TTTTGAGTGGA -> TTTGAGTGGAC
CCAACTTTATT -> CAACTTTATTC
CACGCACTGTC -> ACGCACTGTCC
TCTACAATTAT -> CTACAATTATT
TAGTTAGCCCA -> AGTTAGCCCAG
AGTTTAGCACG -> GTTTAGCACGA
CTGACATGCCC -> TGACATGCCCG
CCGGAAAAAGG -> CGGAAAAAGGG
CTTTATTCCTT -> TTTATTCCTTC
CGGTATGTCTG -> GGTATGTCTGG
TCAAGAATGTC -> CAAGAATGTCG
AACTCAGGTGG -> ACTCAGGTGGA
AATCTCGCATA -> ATCTCGCATAC
AACTTCCTACT -> ACTTCCTACTC
AAATCTATAGC -> AATCTATAGCG
TAGAACGCCTA -> AGAACGCCTAC
GTTGACGCATG -> TTGACGCATGC
GCCAACCTTGT -> CCAACCTTGTT
ATAAGACTGGC -> TAAGACTGGCT
CGACCAGGAGT -> GACCAGGAGTA
AGTGGGGTATG -> GTGGGGTATGG
TTTGGAAGTTT -> TTGGAAGTTTA
CTTAGCTCATA -> TTAGCTCATAG
TTCCTCAGCCC -> TCCTCAGCCCA
TAGTCGATTCG -> AGTCGATTCGA
TAGCCCAGCTC -> AGCCCAGCTCT
GAGGGTATAGA -> AGGGTATAGAA
GAGTGGGGTAT -> AGTGGGGTATG
TTCCGTACACG -> TCCGTACACGC
CTGTTCATTTG -> TGTTCATTTGT
TTGGAAGTTTA -> TGGAAGTTTAG
ATAGTTTTGGT -> TAGTTTTGGTC
TGAGCAACCAT -> GAGCAACCATT
CGAGAAAATCA -> GAGAAAATCAC
ATAGATAATTG -> TAGATAATTGG
GTCAGTCGGAC -> TCAGTCGGACT
ATCGATGATGG -> TCGATGATGGA
CCCAACCCGGG -> CCAACCCGGGA
GGGCAAGTGAA -> GGCAAGTGAAG
ATTCGAGTTTG -> TTCGAGTTTGG
GACCGGTTTGG -> ACCGGTTTGGC
GCCTTTCCTCA -> CCTTTCCTCAG
CTCGCATACCC -> TCGCATACCCC
CATCTTCAACT -> ATCTTCAACTT
ACTCAGGTGGA -> CTCAGGTGGAC
CCGGTCCCCTT -> CGGTCCCCTTC
ACCATTAGTCG -> CCATTAGTCGA
TTTTGCACGTA -> TTTGCACGTAA
CTCATCACAGA -> TCATCACAGAC
GTTAGGGCACT -> TTAGGGCACTG
TCTGGTCTGAA -> CTGGTCTGAAG
GATATTGGCCC -> ATATTGGCCCG
TCCGTACACGC -> CCGTACACGCA
CTCGAGGCATG -> TCGAGGCATGT
AGTGAAGCCTT -> GTGAAGCCTTT
TCCCGATAGCG -> CCCGATAGCGA
CTGATAGCAAA -> TGATAGCAAAT
AAAGCGGCTCG -> AAGCGGCTCGC
ACTGATGGCTT -> CTGATGGCTTT
GTATCGTTAAC -> TATCGTTAACG
GTCATGGCGTG -> TCATGGCGTGC
GGCTTAGTAAT -> GCTTAGTAATG
CGCATACGGGG -> GCATACGGGGT
TATTGCGGAAA -> ATTGCGGAAAC
TGCAACTTTAC -> GCAACTTTACA
CTACACTTGGG -> TACACTTGGGA
GTTTGGCCCGC -> TTTGGCCCGCG
AGTCGGACTTC -> GTCGGACTTCA
ATGATGGACGA -> TGATGGACGAT
GAAAAAGGGTG -> AAAAAGGGTGA
GATAAGACTGG -> ATAAGACTGGC
AGAGGCTCGGC -> GAGGCTCGGCT
ACAGGATTGCA -> CAGGATTGCAT
TCCAGCTAACT -> CCAGCTAACTA
TTGAGTGGACA -> TGAGTGGACAT
CACGAGAAAAT -> ACGAGAAAATC
ATCCGATGATT -> TCCGATGATTA
TCTCGCATACC -> CTCGCATACCC
AGCCTTTTGCA -> GCCTTTTGCAC
AGTCAGTCGGA -> GTCAGTCGGAC
AGGCATGTTTA -> GGCATGTTTAG
GACCCGCGTGC -> ACCCGCGTGCC
AACTGAGTTAG -> ACTGAGTTAGG
TGGCCAACCTT -> GGCCAACCTTG
AGTGGTACGTT -> GTGGTACGTTC
CAGAGTTTAGC -> AGAGTTTAGCA
TTGTCACATAT -> TGTCACATATT
TTTCACCACGG -> TTCACCACGGG
CGTTCTGTTTT -> GTTCTGTTTTG
GGCTCAAGGTC -> GCTCAAGGTCG
CGGGAAAGCAA -> GGGAAAGCAAC
TCTCGGTTTGT -> CTCGGTTTGTC
CATTAGTCGAT -> ATTAGTCGATT
CGTATGACCCG -> GTATGACCCGC
TTTTGCGTCTA -> TTTGCGTCTAA
CCCCATTCGGT -> CCCATTCGGTT
TTTGGTCGCAT -> TTGGTCGCATG
CTAGTTAGCCC -> TAGTTAGCCCA
CGACCTATTTT -> GACCTATTTTT
GCGTGCTGTTC -> CGTGCTGTTCA
CAACTTTATTC -> AACTTTATTCC
ACACTTGGGAT -> CACTTGGGATC
GCTTGCTGCGG -> CTTGCTGCGGA
TACCGATACAT -> ACCGATACATA
GTTCCGTACAC -> TTCCGTACACG
TAATGGCCAAC -> AATGGCCAACC
CTCCTAAAGGG -> TCCTAAAGGGT
TGTCTGGTCTG -> GTCTGGTCTGA
CCTTTTGCACG -> CTTTTGCACGT
CCCAGCTCTAA -> CCAGCTCTAAC
TAATTGGGTCA -> AATTGGGTCAT
AGCTTGCTGCG -> GCTTGCTGCGG
CAATCCGATGA -> AATCCGATGAT
CCCGCGAGTCT -> CCGCGAGTCTC
CTTTTCTTGGC -> TTTTCTTGGCC
TCCCCGCGAGT -> CCCCGCGAGTC
CGGTCCCCTTC -> GGTCCCCTTCA
TGGACGAGCGC -> GGACGAGCGCA
TCGCATACCCC -> CGCATACCCCC
TAAAGGGTCCT -> AAAGGGTCCTT
CCTACGTGGGG -> CTACGTGGGGG
GACGACCTATT -> ACGACCTATTT
TCTATTGCGGA -> CTATTGCGGAA
AACACTTCGAC -> ACACTTCGACT
TCACATATTGG -> CACATATTGGA
AGAAAAATCGT -> GAAAAATCGTC
AATCCAATTAG -> ATCCAATTAGC
CGTCAGTCAGT -> GTCAGTCAGTC
CATTTCACCAC -> ATTTCACCACG
ATTCACAGATG -> TTCACAGATGC
CATGCCCGGCC -> ATGCCCGGCCG
CAGCTCTAACC -> AGCTCTAACCA
ATCCAATTAGC -> TCCAATTAGCT
AGACGGCTCAA -> GACGGCTCAAG
GTTTTTGAGTG -> TTTTTGAGTGG
CACGCTTTTCT -> ACGCTTTTCTT
TTCATTTGTCC -> TCATTTGTCCC
GCTTTTCTTGG -> CTTTTCTTGGC
CCACTGAAGTT -> CACTGAAGTTC
CACCTACACTT -> ACCTACACTTG
CACATTTCGCA -> ACATTTCGCAA
AATTCCGTGGG -> ATTCCGTGGGT
GGTCATTCTAC -> GTCATTCTACC
TTGGAGAGCAT -> TGGAGAGCATT
CCAGGAGTATT -> CAGGAGTATTG
GTTAACGAGAC -> TTAACGAGACG
GTCGGCGCAAA -> TCGGCGCAAAT
GGCAAAAGTTC -> GCAAAAGTTCC
CCGCGTGCCTT -> CGCGTGCCTTT
CCAGGCACTCA -> CAGGCACTCAT
TTTCGTCAGTC -> TTCGTCAGTCA
CAGATGGGACC -> AGATGGGACCG
TTTCTAAAGAA -> TTCTAAAGAAT
CAATTATTTCC -> AATTATTTCCT
GTGGACGAGCG -> TGGACGAGCGC
TTTAGAGTTCG -> TTAGAGTTCGG
CTGAAGCACTC -> TGAAGCACTCA
GAGATGTTTTA -> AGATGTTTTAG
CCAAGCGGCGC -> CAAGCGGCGCA
TGCAAGCGTAT -> GCAAGCGTATG
ACCGATACATA -> CCGATACATAC
GGACTTCAGAC -> GACTTCAGACG
CCTAGTTAGCC -> CTAGTTAGCCC
CCCCCATTCGG -> CCCCATTCGGT
ATAGCAAATTT -> TAGCAAATTTT
CGGGGTCAAGA -> GGGGTCAAGAA
TATCATAGACG -> ATCATAGACGG
CAGACGTCAGA -> AGACGTCAGAA
AGGCACTCATC -> GGCACTCATCA
GAGGGCTAGCT -> AGGGCTAGCTT
GTTTTCGTAAC -> TTTTCGTAACA
TACGACCTCCT -> ACGACCTCCTA
GTTAGGCACGA -> TTAGGCACGAG
TTTTCGTAACA -> TTTCGTAACAC
AGTAATGCAAC -> GTAATGCAACT
CTGGCTTGCTC -> TGGCTTGCTCC
AGCCACTGAAG -> GCCACTGAAGT
CTCATAATGGT -> TCATAATGGTT
CGGCTCGCTGT -> GGCTCGCTGTT
GTGTACCTTTG -> TGTACCTTTGG
CGGAATCTTAA -> GGAATCTTAAT
TTGACCCAACC -> TGACCCAACCC
GCTGCGCGTAC -> CTGCGCGTACA
CGCTCTGTGTA -> GCTCTGTGTAC
AATCTTAATGG -> ATCTTAATGGC
CGAGACGGTTA -> GAGACGGTTAT
CGGAGTTAGGC -> GGAGTTAGGCA
CCAACCTTGTT -> CAACCTTGTTT
CATTCACGTCC -> ATTCACGTCCT
GGCTAGCTTGC -> GCTAGCTTGCT
TCCGGAAAAAG -> CCGGAAAAAGG
GGTATAGAACG -> GTATAGAACGC
GACGGCGAGAG -> ACGGCGAGAGT
GTTGGGGCTCA -> TTGGGGCTCAG
GCCGTATGCAT -> CCGTATGCATT
ACGACCTATTT -> CGACCTATTTT
GTCTCAGTGGA -> TCTCAGTGGAC
TTCTGTTTTGG -> TCTGTTTTGGC
TACATCCCTCA -> ACATCCCTCAG
ATGGAGGCAAG -> TGGAGGCAAGA
CGTATGCATTG -> GTATGCATTGG
GCATGTCGGCA -> CATGTCGGCAA
ACTCGAGGCAT -> CTCGAGGCATG
CGTCTAACCCC -> GTCTAACCCCC
TTGGCCCGCGA -> TGGCCCGCGAC
TTCGACTGCAA -> TCGACTGCAAC
CCGTGGGTTTT -> CGTGGGTTTTC
AAGCACTCATA -> AGCACTCATAA
GGCGCAAAGCG -> GCGCAAAGCGG
ACGCCTACGTG -> CGCCTACGTGG
CTGTCCAGTAG -> TGTCCAGTAGC
TGGCCCGCGAC -> GGCCCGCGACC
TGGAGAGCATT -> GGAGAGCATTC
ATTTGACTTCG -> TTTGACTTCGT
GAAGCACTCAT -> AAGCACTCATA
ATTCCTTCAGT -> TTCCTTCAGTT
CAACTTTACAG -> AACTTTACAGT
AAACTGAGTTA -> AACTGAGTTAG
TTCACGTCCTC -> TCACGTCCTCG
AGCAGATACCC -> GCAGATACCCT
ACGAGGGCTAG -> CGAGGGCTAGC
GGTTTGTCACA -> GTTTGTCACAT
TTTGTTCCGTA -> TTGTTCCGTAC
GTTTTGGTCGC -> TTTTGGTCGCA
CTACTCGCATA -> TACTCGCATAC
GCCTTTTGCAC -> CCTTTTGCACG
ACGCACTGTCC -> CGCACTGTCCA
TCAGACGGCGA -> CAGACGGCGAG
CGGCAAAAGTT -> GGCAAAAGTTC
GGGGTATCGTT -> GGGTATCGTTA
AATTAGATCAC -> ATTAGATCACA
CCAATTAGATC -> CAATTAGATCA
AGCACTCATAA -> GCACTCATAAT
GGGTCGGCGCA -> GGTCGGCGCAA
AATTTTGCGTC -> ATTTTGCGTCT
GGTTGGGGCTC -> GTTGGGGCTCA
TGCCGAGAGAA -> GCCGAGAGAAT
TTAGCACGAGA -> TAGCACGAGAA
CGGTTTCTAAA -> GGTTTCTAAAG
CCCTGATAGCA -> CCTGATAGCAA
CGAGTGGTACG -> GAGTGGTACGT
AGGACCTACCA -> GGACCTACCAA
TCGATGATGGA -> CGATGATGGAC
ATTAGATCACA -> TTAGATCACAT
GCCAATTAAGG -> CCAATTAAGGG
CGGACGAGGGC -> GGACGAGGGCT
ACTGCAACATA -> CTGCAACATAC
GCGGAGCATTT -> CGGAGCATTTC
GCAAGTGAAGC -> CAAGTGAAGCC
TCGGCTTAGTA -> CGGCTTAGTAA
CCCATCTTCAA -> CCATCTTCAAC
GTTATTTGACT -> TTATTTGACTT
GTCATTCTACC -> TCATTCTACCC
TCGAGTTTGGA -> CGAGTTTGGAA
AGTTTTGGTCG -> GTTTTGGTCGC
CATCCACCTAC -> ATCCACCTACA
AAGACCTCCGA -> AGACCTCCGAG
GTCCATAGATA -> TCCATAGATAA
CTTGTTTTTGA -> TTGTTTTTGAG
CTGGCTAACTC -> TGGCTAACTCT
ATGGCCAACCT -> TGGCCAACCTT
CATCCCTCAGA -> ATCCCTCAGAC
AAGGGCAAGTG -> AGGGCAAGTGA
ATCTATAGCGG -> TCTATAGCGGG
TCACAGATGCG -> CACAGATGCGT
ACCAGGCACTC -> CCAGGCACTCA
AGATACCCTGA -> GATACCCTGAT
TTCCAACTTTA -> TCCAACTTTAT
CGAGCGCAGAT -> GAGCGCAGATC
AGAGTTTAGCA -> GAGTTTAGCAC
TTCAACTTACG -> TCAACTTACGG
ATTAGTCGATT -> TTAGTCGATTC
TGAGTTAGGGC -> GAGTTAGGGCA
TGGGGGTATCG -> GGGGGTATCGT
TTATTCCTTCA -> TATTCCTTCAG
TGCCCGGCCGG -> GCCCGGCCGGT
ACTCGCATACG -> CTCGCATACGG
ATACGCTGACA -> TACGCTGACAT
GAGAGAATCCA -> AGAGAATCCAA
AATACGCTGAC -> ATACGCTGACA
GCCCGCGACCT -> CCCGCGACCTG
GGGGGTATCGT -> GGGGTATCGTT
CGTACACGCTT -> GTACACGCTTT
GGCAAGACTGA -> GCAAGACTGAT
TTTCCCGATAG -> TTCCCGATAGC
GGTTATTTGAC -> GTTATTTGACT
CTCGCGACGGT -> TCGCGACGGTT
CCTCCGAGTGC -> CTCCGAGTGCC
TTCCTTCAGTT -> TCCTTCAGTTG
ACAATTATTTC -> CAATTATTTCC
TCACTGAGCAA -> CACTGAGCAAA
GGCATGTTTAG -> GCATGTTTAGG
GACGAGGGCTA -> ACGAGGGCTAG
GGTTCACGGCA -> GTTCACGGCAT
TTATGTCGGTA -> TATGTCGGTAT
ATGTCTGGTCT -> TGTCTGGTCTG
TTTTAGAGTTC -> TTTAGAGTTCG
ATCTTAATGGC -> TCTTAATGGCC
GACCTCCGAGT -> ACCTCCGAGTG
CGTTCTGGCTT -> GTTCTGGCTTG
ATGCAACTTTA -> TGCAACTTTAC
GATGATGGACG -> ATGATGGACGA
ACATACGTAAT -> CATACGTAATA
TGTCGGCTTGG -> GTCGGCTTGGC
AACTTTACAGT -> ACTTTACAGTA
TCAGAACAGGA -> CAGAACAGGAT
TACCCTGATAG -> ACCCTGATAGC
CGTAATTGGTC -> GTAATTGGTCT
GGTGGACGAGC -> GTGGACGAGCG
AGTTTGTTCCG -> GTTTGTTCCGT
CCGTCTCAGTG -> CGTCTCAGTGG
GTCCTTACCTA -> TCCTTACCTAG
GTTTAGAGATG -> TTTAGAGATGT
CATTCTTCTCG -> ATTCTTCTCGG
CAAGAATGTCG -> AAGAATGTCGG
AATCTATAGCG -> ATCTATAGCGG
TTAGTCGATTC -> TAGTCGATTCG
CCTTTCCTCAG -> CTTTCCTCAGC
CCCGGCCGGTG -> CCGGCCGGTGC
GAGTCTCTCTG -> AGTCTCTCTGA
TTTCGCAAAGG -> TTCGCAAAGGG
GTACATCCACC -> TACATCCACCT
CGAGTCTCTCT -> GAGTCTCTCTG
TGTACCTTTGG -> GTACCTTTGGT
TCTCCAGCTAA -> CTCCAGCTAAC
TGGATACGTCA -> GGATACGTCAT
GCCGGCGAAAG -> CCGGCGAAAGA
AGACGTCAGAA -> GACGTCAGAAC
AAAGTTCCAAC -> AAGTTCCAACT
GGTGCGACCAG -> GTGCGACCAGG
TAGCTTGCTGC -> AGCTTGCTGCG
AAGCGGCTCGC -> AGCGGCTCGCT
TCCGAGTGCCG -> CCGAGTGCCGA
GACCTCCTAAA -> ACCTCCTAAAG
AAGTTCCAACT -> AGTTCCAACTT
GCGACCAGGAG -> CGACCAGGAGT
GCCATTGATAA -> CCATTGATAAC
GCTAACTCTGC -> CTAACTCTGCC
GACGGTTCACG -> ACGGTTCACGG
TGGTCTGAAGC -> GGTCTGAAGCA
AGCGTATGACC -> GCGTATGACCC
TCGGCGGACGA -> CGGCGGACGAG
GCCCGGCCGGT -> CCCGGCCGGTG
CCTTCATCGAG -> CTTCATCGAGC
TGTGCAAACAA -> GTGCAAACAAA
TACCTTTGGTA -> ACCTTTGGTAT
GACCTATTTTT -> ACCTATTTTTG
CAGTGGACCCA -> AGTGGACCCAT
ATCCCTCAGAC -> TCCCTCAGACG
ACGTAATTGGT -> CGTAATTGGTC
TCCTTCATCGA -> CCTTCATCGAG
GGGTGAGGGTA -> GGTGAGGGTAT
TTGGTCGCATG -> TGGTCGCATGT
TTCACTGTTGA -> TCACTGTTGAC
GATGCGTCCAT -> ATGCGTCCATA
AGATCACATTT -> GATCACATTTC
GGCACGAGTGG -> GCACGAGTGGT
TCGAGGCATGT -> CGAGGCATGTT
GCGGGGCATTT -> CGGGGCATTTC
CACTCATCACA -> ACTCATCACAG
GTCGGTATGTC -> TCGGTATGTCT
ATTGGCCCGGT -> TTGGCCCGGTC
AGAGATGTTTT -> GAGATGTTTTA
AGTTGCGGTAC -> GTTGCGGTACG
AGCAGCCAGCA -> GCAGCCAGCAA
ACGAGACGGTT -> CGAGACGGTTA
GGCCAATTAAG -> GCCAATTAAGG
CGGCATTGCGA -> GGCATTGCGAT
CTTCATCGAGC -> TTCATCGAGCC
TTCCTACTCGC -> TCCTACTCGCA
GGGATCCAGAG -> GGATCCAGAGG
GGTATCATAGA -> GTATCATAGAC
ACCTTGTTTTT -> CCTTGTTTTTG
TGCACGTAATT -> GCACGTAATTG
TGGGACCGGTT -> GGGACCGGTTT
AAAAATCGTCT -> AAAATCGTCTG
CAGCCCACAGG -> AGCCCACAGGT
GTCGATTCGAG -> TCGATTCGAGT
TTGTTTTTGAG -> TGTTTTTGAGT
TAGCTTGATGG -> AGCTTGATGGC
GGGATCGGCGG -> GGATCGGCGGA
TGCGGTACGGG -> GCGGTACGGGG
TGACTTCGTTC -> GACTTCGTTCT
GACGGCTCAAG -> ACGGCTCAAGG
ATTGCAAGCGT -> TTGCAAGCGTA
CGTCTACAATT -> GTCTACAATTA
GATGGCCAATT -> ATGGCCAATTA
TGCATTGGGAA -> GCATTGGGAAC
CTTGATGGCCA -> TTGATGGCCAA
ACTTCAGACGG -> CTTCAGACGGC
CGGTTATTTGA -> GGTTATTTGAC
GATCGATGATG -> ATCGATGATGG
CGTCAGAACAG -> GTCAGAACAGG
ACTCATAATGG -> CTCATAATGGT
TCCGTGGGTTT -> CCGTGGGTTTT
CTGTTGCATTC -> TGTTGCATTCA
GTTAGTTTGTT -> TTAGTTTGTTC
CTGTTGCATTG -> TGTTGCATTGG
TGTTGCATTGG -> GTTGCATTGGG
CCCCCGATTGT -> CCCCGATTGTT
ATCGTCTACAA -> TCGTCTACAAT
AATCCGATGAT -> ATCCGATGATT
GCAAAGCGGCT -> CAAAGCGGCTC
CGCTGACATGC -> GCTGACATGCC
TTCAGTTGCGG -> TCAGTTGCGGT
CTTCAGACGGC -> TTCAGACGGCG
GGCCAACCTTG -> GCCAACCTTGT
GGAGGCAAGAC -> GAGGCAAGACT
GGCATTGCGAT -> GCATTGCGATC
GGGGCACGCGG -> GGGCACGCGGA
CCCCGCGAGTC -> CCCGCGAGTCT
GCATAGTTTTG -> CATAGTTTTGG
GTATTGTGCCG -> TATTGTGCCGT
TATGCATTGGT -> ATGCATTGGTG
GCTTGCTCCCA -> CTTGCTCCCAA
AGGGTATAGAA -> GGGTATAGAAC
GCGTCTAACCC -> CGTCTAACCCC
TCCAATTAGCT -> CCAATTAGCTT
CGGCTCAAGGT -> GGCTCAAGGTC
CTGTGTACCTT -> TGTGTACCTTT
AACTTACGGTC -> ACTTACGGTCC
CTTGCTCCCAA -> TTGCTCCCAAG
TTATTTGACTT -> TATTTGACTTC
GATACGTCATG -> ATACGTCATGG
GCAAAGGGTCG -> CAAAGGGTCGG
TCGACTGCAAC -> CGACTGCAACA
TATTTGACTTC -> ATTTGACTTCG
ACCCAACCCGG -> CCCAACCCGGG
GAGTTTGGAAG -> AGTTTGGAAGT
CTACAATTATT -> TACAATTATTT
AGACGGTTATT -> GACGGTTATTT
ACGCTTTTCTT -> CGCTTTTCTTG
ATCACAGACAG -> TCACAGACAGA
AGTAGCAGCCA -> GTAGCAGCCAG
GTTCGGACTTC -> TTCGGACTTCA
AGTGGACCCAT -> GTGGACCCATC
AAGGGTGAGGG -> AGGGTGAGGGT
ATCACATTTCG -> TCACATTTCGC
GGATCCAGAGG -> GATCCAGAGGC
CAGGTGGACGA -> AGGTGGACGAG
GCCCACAGGTC -> CCCACAGGTCT
TTGGTCTCCAG -> TGGTCTCCAGC
CTGCGGAATCT -> TGCGGAATCTT
TCTATAGCGGG -> CTATAGCGGGA
ACTGAAGTTCT -> CTGAAGTTCTA
TAGCAGCCAGC -> AGCAGCCAGCA
ATTGCGATCGA -> TTGCGATCGAT
TTGCCGCGGAG -> TGCCGCGGAGC
GGCCCGGTCCC -> GCCCGGTCCCC
AATTGGGTCAT -> ATTGGGTCATT
TTCTTCTCGGT -> TCTTCTCGGTT
GTAATACGCTG -> TAATACGCTGA
AGCAATCCGAT -> GCAATCCGATG
GACTTCGTTCT -> ACTTCGTTCTG
ACCTATTTTTG -> CCTATTTTTGC
TGGTTGGGGCT -> GGTTGGGGCTC
GATACCCTGAT -> ATACCCTGATA
GCTGACATGCC -> CTGACATGCCC
TGATAGCAAAT -> GATAGCAAATT
TGGCGTGCTGT -> GGCGTGCTGTT
AGGGTCCTTAC -> GGGTCCTTACC
GTATGTCTGGT -> TATGTCTGGTC
CTCCGAGTGCC -> TCCGAGTGCCG
TTGGTATCATA -> TGGTATCATAG
CTTCAGAGTTT -> TTCAGAGTTTA
AATTAGCTTGA -> ATTAGCTTGAT
ATTCCGTGGGT -> TTCCGTGGGTT
CAGATCGTCTA -> AGATCGTCTAC
AGGGCAAGTGA -> GGGCAAGTGAA
ATAATGGTTGG -> TAATGGTTGGG
AGACCTCCGAG -> GACCTCCGAGT
CGTAACACTTC -> GTAACACTTCG
GCATCCCCGCG -> CATCCCCGCGA
ACCCAATTAGA -> CCCAATTAGAT
TGTTCACTGTT -> GTTCACTGTTG
CTTTTGCACGT -> TTTTGCACGTA
CGTCTCAGTGG -> GTCTCAGTGGA
CCCGGGACAAA -> CCGGGACAAAC
TGTTAGTTTGT -> GTTAGTTTGTT
CGCGGAGTTAG -> GCGGAGTTAGG
ATCGTTAACGA -> TCGTTAACGAG
TGTGTACCTTT -> GTGTACCTTTG
GAAAGACCTCC -> AAAGACCTCCG
AAGTTTAGAGA -> AGTTTAGAGAT
ACTGAGTTAGG -> CTGAGTTAGGG
CAAGGTCGCGG -> AAGGTCGCGGG
CACTGTTGCAT -> ACTGTTGCATT
GTACGTTCGGT -> TACGTTCGGTA
ATCCACCTACA -> TCCACCTACAC
GCTCATAGGAC -> CTCATAGGACC
TTAACGAGACG -> TAACGAGACGG
CCTATTTTTGC -> CTATTTTTGCT
AAACTCGAGGC -> AACTCGAGGCA
TTAATGGCCAA -> TAATGGCCAAC
GCATTGGTGTG -> CATTGGTGTGC
TTCGTTCTGTT -> TCGTTCTGTTT
CAGGATTGCAT -> AGGATTGCATC
AGCATTCACAG -> GCATTCACAGA
ACTGATAAGAC -> CTGATAAGACT
TCCATAGATAA -> CCATAGATAAT
GGGTCATTCTA -> GGTCATTCTAC
ATCGAGCCACT -> TCGAGCCACTG
TGGCTTTTTTT -> GGCTTTTTTTT
GTAGCAGCCAG -> TAGCAGCCAGC
CGGTTTGGCCC -> GGTTTGGCCCG
TTAGCTCATAG -> TAGCTCATAGG
TCATAGGACCT -> CATAGGACCTA
CCAGCTCTAAC -> CAGCTCTAACC
CTTTACAGTAT -> TTTACAGTATT
GGCGAGAGTGG -> GCGAGAGTGGA
TGCTGCGCGTA -> GCTGCGCGTAC
AGCTCTAACCA -> GCTCTAACCAG
TTGGCCCGGTC -> TGGCCCGGTCC
ACATTTCGCAA -> CATTTCGCAAA
GCGCAAATCTA -> CGCAAATCTAT
ATTGATAACTC -> TTGATAACTCA
TGGAAGTTTAG -> GGAAGTTTAGA
GGACCCATCTT -> GACCCATCTTC
CACATATTGGA -> ACATATTGGAG
CCTCGCTCTGT -> CTCGCTCTGTG
CTAATCTATTG -> TAATCTATTGC
GAACAGGATTG -> AACAGGATTGC
CTATTTTTGCT -> TATTTTTGCTG
GAGCGCAGATC -> AGCGCAGATCG
ATTGTTCACTG -> TTGTTCACTGT
GATCCAGAGGC -> ATCCAGAGGCT
CATGGCGTGCT -> ATGGCGTGCTG
AACAAACTGAG -> ACAAACTGAGT
CAACATACCGT -> AACATACCGTA
CCGGTGCGACC -> CGGTGCGACCA
CATACCGTACA -> ATACCGTACAC
ATTTTTGCTGC -> TTTTTGCTGCG
GCACTCATAAT -> CACTCATAATG
CAGTGTTGACC -> AGTGTTGACCC
GCCGCGGAGCA -> CCGCGGAGCAT
CATACGGGGTC -> ATACGGGGTCA
TAGTAATGCAA -> AGTAATGCAAC
ATTACGACCTC -> TTACGACCTCC
GGAGTTAGGCA -> GAGTTAGGCAC
AGTTAGGCACG -> GTTAGGCACGA
CACGGGAAAGC -> ACGGGAAAGCA
TCCCTGGCATA -> CCCTGGCATAG
CCAACCCGGGA -> CAACCCGGGAC
CACGTAATTGG -> ACGTAATTGGT
TTAGTTTGTTC -> TAGTTTGTTCC
GGACTTCAGTG -> GACTTCAGTGT
TACACGCACTG -> ACACGCACTGT
ACCCCCATTCG -> CCCCCATTCGG
AAACAAACTGA -> AACAAACTGAG
TAGATCACATT -> AGATCACATTT
CGTCCTCGCTC -> GTCCTCGCTCT
AATTAAGGGCA -> ATTAAGGGCAA
CCACCTACACT -> CACCTACACTT
AGTGTTGACCC -> GTGTTGACCCA
GACATGCCCGG -> ACATGCCCGGC
CAGTATTTCGT -> AGTATTTCGTC
CCATTCTTCTC -> CATTCTTCTCG
GTTGCATTCAC -> TTGCATTCACG
GCCTACGTGGG -> CCTACGTGGGG
CGCGAGTCTCT -> GCGAGTCTCTC
GTCACATATTG -> TCACATATTGG
TGGCATACCCC -> GGCATACCCCA
AATCGTCTGGA -> ATCGTCTGGAG
AGTATTTCGTC -> GTATTTCGTCA
TCTGGCTTGCT -> CTGGCTTGCTC
CTTTGGTATCA -> TTTGGTATCAT
GCAGCCAGCAA -> CAGCCAGCAAT
ATCGGCGGACG -> TCGGCGGACGA
GCTCTAACCAG -> CTCTAACCAGG
ATGAACTGATA -> TGAACTGATAA
CACTTCGACTG -> ACTTCGACTGC
GGTCTGAAGCA -> GTCTGAAGCAC
TGGCCATTCTT -> GGCCATTCTTC
TTTTCTTGGCC -> TTTCTTGGCCA
CTCAGGTGGAC -> TCAGGTGGACG
CCTGGCATAGT -> CTGGCATAGTT
CAGATGCGTCC -> AGATGCGTCCA
TGCCGCGGAGC -> GCCGCGGAGCA
GACAAACTTCC -> ACAAACTTCCT
CACGAGTGGTA -> ACGAGTGGTAC
TTGGGAACACA -> TGGGAACACAA
TGGCGCCATTG -> GGCGCCATTGA
GATAATTGGGT -> ATAATTGGGTC
AGCCCACAGGT -> GCCCACAGGTC
GCGTACATCCA -> CGTACATCCAC
GCCACTGAAGT -> CCACTGAAGTT
ACTGTCCAGTA -> CTGTCCAGTAG
AGGGCACTGTT -> GGGCACTGTTG
GCGGCGCAAAG -> CGGCGCAAAGC
TGGAGTGGGGT -> GGAGTGGGGTA
TTCGGTACATC -> TCGGTACATCC
CCCAAGCGGCG -> CCAAGCGGCGC
CGTCTGGAGTG -> GTCTGGAGTGG
TATTGGCCCGG -> ATTGGCCCGGT
GGCACTGTTGC -> GCACTGTTGCA
CTAACCAGGCA -> TAACCAGGCAC
TTGATAACTCA -> TGATAACTCAG
AAGCAGATACC -> AGCAGATACCC
CTTCGACTGCA -> TTCGACTGCAA
TTCTGGCTTGC -> TCTGGCTTGCT
CCGCGGAGCAT -> CGCGGAGCATT
GACCCATCTTC -> ACCCATCTTCA
TTCAGAGTTTA -> TCAGAGTTTAG
GGCACGCGGAG -> GCACGCGGAGT
TCAACTTACGG -> CAACTTACGGT
TGACATGCCCG -> GACATGCCCGG
TCTGAGCAACC -> CTGAGCAACCA
TTTATTCCTTC -> TTATTCCTTCA
CGGCGAAAGAC -> GGCGAAAGACC
TCGGCAAAAGT -> CGGCAAAAGTT
ACCGTACACGC -> CCGTACACGCT
AGAGAATCCAA -> GAGAATCCAAT
AGAATTGCCGC -> GAATTGCCGCG
TGATAAGACTG -> GATAAGACTGG
TCCTTCAGTTG -> CCTTCAGTTGC
AGATCGTCTAC -> GATCGTCTACA
GGAATCTTAAT -> GAATCTTAATG
CGGACTTCAGA -> GGACTTCAGAC
CAGACAGAAAA -> AGACAGAAAAA
CACGGCATTGC -> ACGGCATTGCG
CGGACTTCAGT -> GGACTTCAGTG
TAGATAATTGG -> AGATAATTGGG
CATAGTTTTGG -> ATAGTTTTGGT
ACGGTCCGGAA -> CGGTCCGGAAA
GTACACGCACT -> TACACGCACTG
CGGGGCATTTC -> GGGGCATTTCA
TCCAGAGGCTC -> CCAGAGGCTCG
GAGAATCCAAT -> AGAATCCAATT
TACTCGCATAC -> ACTCGCATACG
GGCGAAAGACC -> GCGAAAGACCT
CACTGAAGTTC -> ACTGAAGTTCT
CATGTTTAGGG -> ATGTTTAGGGA
GGTTTCTAAAG -> GTTTCTAAAGA
CGGTGCGACCA -> GGTGCGACCAG
TTGCGTCTAAC -> TGCGTCTAACC
CCGGCCGGTGC -> CGGCCGGTGCG
GGGCACGCGGA -> GGCACGCGGAG
GCGGTACGGGG -> CGGTACGGGGC
TACGCTGACAT -> ACGCTGACATG
GGGAACACAAT -> GGAACACAATT
TTACAGTATTT -> TACAGTATTTC
GAAGCCTTTTG -> AAGCCTTTTGC
ACGAGTGGTAC -> CGAGTGGTACG
CTCTGTGTACC -> TCTGTGTACCT
ATTGGGTCATT -> TTGGGTCATTC
GCTAGCTTGCT -> CTAGCTTGCTG
AGGCAAGACTG -> GGCAAGACTGA
CTAGCGTTCTG -> TAGCGTTCTGG
GCAACTTTACA -> CAACTTTACAG
CATTCTACCCA -> ATTCTACCCAA
GCTCCCAAGCG -> CTCCCAAGCGG
AAGGTCGCGGG -> AGGTCGCGGGG
TTTCCTCAGCC -> TTCCTCAGCCC
GCGTGCCTTTC -> CGTGCCTTTCC
AGCTCATAGGA -> GCTCATAGGAC
CGCAAAGGGTC -> GCAAAGGGTCG
TGGGAACACAA -> GGGAACACAAT
GGAAACTCGAG -> GAAACTCGAGG
CAGGCACTCAT -> AGGCACTCATC
GTGGACCCATC -> TGGACCCATCT
TTAGGGATCCA -> TAGGGATCCAG
TAGCAAATTTT -> AGCAAATTTTG
GCAGATCGTCT -> CAGATCGTCTA
TCTTCAACTTA -> CTTCAACTTAC
ATCATAGACGG -> TCATAGACGGC
ATAACTCAGGT -> TAACTCAGGTG
TGAAGCCTTTT -> GAAGCCTTTTG
GATTCGAGTTT -> ATTCGAGTTTG
TCCGATGATTA -> CCGATGATTAC
GCGCAGATCGT -> CGCAGATCGTC
GCGGACGAGGG -> CGGACGAGGGC
CGATCGATGAT -> GATCGATGATG
GGTATGGAGGC -> GTATGGAGGCA
AGAGCATTCAC -> GAGCATTCACA
TAACACTTCGA -> AACACTTCGAC
GAAGTTTAGAG -> AAGTTTAGAGA
GCACTCATCAC -> CACTCATCACA
GGCGTGCTGTT -> GCGTGCTGTTC
CCAATCTCGCA -> CAATCTCGCAT
TACATCCACCT -> ACATCCACCTA
AACTCTGCCTG -> ACTCTGCCTGG
CAGTCAGTCGG -> AGTCAGTCGGA
GTACATCCCTC -> TACATCCCTCA
GATAGCAAATT -> ATAGCAAATTT
CGTGGGGGTAT -> GTGGGGGTATC
CCCGGTCCCCT -> CCGGTCCCCTT
GACGGTTATTT -> ACGGTTATTTG
ATCTATTGCGG -> TCTATTGCGGA
GTTTTAGAGTT -> TTTTAGAGTTC
TTGGGGCTCAG -> TGGGGCTCAGT
GCTCGCTGTTG -> CTCGCTGTTGC
ACGCTGACATG -> CGCTGACATGC
AGGGATCCAGA -> GGGATCCAGAG
CCTTCAGAGTT -> CTTCAGAGTTT
TACGTAATACG -> ACGTAATACGC
ACAGTATTTCG -> CAGTATTTCGT
AACTCGAGGCA -> ACTCGAGGCAT
CTTTCCTCAGC -> TTTCCTCAGCC
TCTTAGCTCAT -> CTTAGCTCATA
ATAGGACCTAC -> TAGGACCTACC
TGGACCCATCT -> GGACCCATCTT
ACCCGCGTGCC -> CCCGCGTGCCT
ACGTAATACGC -> CGTAATACGCT
AACACAATTCC -> ACACAATTCCG
ATAGCGGGACT -> TAGCGGGACTC
TTTTGGCATAC -> TTTGGCATACC
CGATGATTACG -> GATGATTACGA
GCCCGGTCCCC -> CCCGGTCCCCT
TCTGCCTGGGC -> CTGCCTGGGCC
ATTGGTCTCCA -> TTGGTCTCCAG
AAAAGGGTGAG -> AAAGGGTGAGG
TTCGGACTTCA -> TCGGACTTCAG
CGCGGGGCATT -> GCGGGGCATTT
TCATAGACGGC -> CATAGACGGCT
TAACCCCCATT -> AACCCCCATTC
CGGGACTCGCG -> GGGACTCGCGA
CGCTTTTCTTG -> GCTTTTCTTGG
TTGGCATACCC -> TGGCATACCCC
GTCCCTGGCAT -> TCCCTGGCATA
TGCCTTTCCTC -> GCCTTTCCTCA
TGTTTTTGAGT -> GTTTTTGAGTG
AGGCTCGGCTT -> GGCTCGGCTTA
GGCGCCATTGA -> GCGCCATTGAT
TATTCCTTCAG -> ATTCCTTCAGT
TGAGCAAAGCA -> GAGCAAAGCAG
GTTCTGTTTTG -> TTCTGTTTTGG
GTGTATTGCAA -> TGTATTGCAAG
CCATTAGTCGA -> CATTAGTCGAT
TCACATTTCGC -> CACATTTCGCA
TTTGTCACATA -> TTGTCACATAT
CGCAAAGCGGC -> GCAAAGCGGCT
TAGGGATCCAG -> AGGGATCCAGA
TGAAGCACTCA -> GAAGCACTCAT
ACAGATGGGAC -> CAGATGGGACC
TTTCGTAACAC -> TTCGTAACACT
TGTTGACCCAA -> GTTGACCCAAC
GCACGAGAAAA -> CACGAGAAAAT
GGCCGGCGAAA -> GCCGGCGAAAG
CAAATCTATAG -> AAATCTATAGC
CTTCGTTCTGT -> TTCGTTCTGTT
GCAGATACCCT -> CAGATACCCTG
GTTGCGGTACG -> TTGCGGTACGG
CGCAGATCGTC -> GCAGATCGTCT
CGACGGTTCAC -> GACGGTTCACG
CGCATGTCGGC -> GCATGTCGGCA
GAGGCAAGACT -> AGGCAAGACTG
GTTTAGCACGA -> TTTAGCACGAG
CTGTTAGTTTG -> TGTTAGTTTGT
GGTTTGGCCCG -> GTTTGGCCCGC
CGGTTCACGGC -> GGTTCACGGCA
GTGGGGTATGG -> TGGGGTATGGA
TAGCTCATAGG -> AGCTCATAGGA
GTCTGGTCTGA -> TCTGGTCTGAA
TTGCATTGGGA -> TGCATTGGGAA
GAGAAAATCAC -> AGAAAATCACT
TGGTGTGCAAA -> GGTGTGCAAAC
GTATGCATTGG -> TATGCATTGGT
ACCTACACTTG -> CCTACACTTGG
AAAGAATTGCC -> AAGAATTGCCG
GCAATCCGATG -> CAATCCGATGA
CATTCACAGAT -> ATTCACAGATG
GGCATTTCACC -> GCATTTCACCA
ATACCCTGATA -> TACCCTGATAG
TGTTCATTTGT -> GTTCATTTGTC
TGCATTCACGT -> GCATTCACGTC
GCTGCGGAATC -> CTGCGGAATCT
TAGGGCACTGT -> AGGGCACTGTT
ACGCATGCCGT -> CGCATGCCGTA
TGGGGTATGGA -> GGGGTATGGAG
ATACCCCCGAT -> TACCCCCGATT
CTCGGCTTAGT -> TCGGCTTAGTA
ATGACCCGCGT -> TGACCCGCGTG
GCCGGTGCGAC -> CCGGTGCGACC
CATATTGGAGA -> ATATTGGAGAG
CATGCCGTATG -> ATGCCGTATGC
AGGAGTATTGT -> GGAGTATTGTG
CAAGTGAAGCC -> AAGTGAAGCCT
CCGATACATAC -> CGATACATACA
ATTCACGTCCT -> TTCACGTCCTC
TGAAGTTCTAG -> GAAGTTCTAGC
GTATTTCGTCA -> TATTTCGTCAG
TCAGTTGCGGT -> CAGTTGCGGTA
TACACGCTTTT -> ACACGCTTTTC
GACTCGCGACG -> ACTCGCGACGG
CAGCCAGCAAT -> AGCCAGCAATC
TTCCGTGGGTT -> TCCGTGGGTTT
TGCATCCCCGC -> GCATCCCCGCG
TTGCGGTACGG -> TGCGGTACGGG
CCTTCAGTTGC -> CTTCAGTTGCG
CAGAACAGGAT -> AGAACAGGATT
GCGGAATCTTA -> CGGAATCTTAA
ACAGAAAAATC -> CAGAAAAATCG
GTACCTTTGGT -> TACCTTTGGTA
TCAGAGTTTAG -> CAGAGTTTAGC
TAGGCACGAGT -> AGGCACGAGTG
GTGCGACCAGG -> TGCGACCAGGA
TGTGCCGTCTC -> GTGCCGTCTCA
ACGGGGCACGC -> CGGGGCACGCG
TTGTCCCTGGC -> TGTCCCTGGCA
AGAACAGGATT -> GAACAGGATTG
AGTTTAGAGAT -> GTTTAGAGATG
TCGTAACACTT -> CGTAACACTTC
GTGTTGACCCA -> TGTTGACCCAA
GTGCAAACAAA -> TGCAAACAAAC
GGCCGGTGCGA -> GCCGGTGCGAC
ACGTTCGGTAC -> CGTTCGGTACA
ATTGTGCCGTC -> TTGTGCCGTCT
TCAGTGTTGAC -> CAGTGTTGACC
AGTTTGGAAGT -> GTTTGGAAGTT
AGCTTGATGGC -> GCTTGATGGCC
TCTGTGTACCT -> CTGTGTACCTT
TGATGGCCAAT -> GATGGCCAATT
GAATCTTAATG -> AATCTTAATGG
CGAGTTTGGAA -> GAGTTTGGAAG
TTCGTCAGTCA -> TCGTCAGTCAG
TGGCATAGTTT -> GGCATAGTTTT
ACTATGAACTG -> CTATGAACTGA
TAGGACCTACC -> AGGACCTACCA
TAATTGGTCTC -> AATTGGTCTCC
TTCTAAAGAAT -> TCTAAAGAATT
ACTGTTGCATT -> CTGTTGCATTG
CGCAAATCTAT -> GCAAATCTATA
GTCAAGAATGT -> TCAAGAATGTC
CCAGCTAACTA -> CAGCTAACTAA
GAGTTAGGCAC -> AGTTAGGCACG
GAGAGTGGATA -> AGAGTGGATAC
AGCAAAGCAGA -> GCAAAGCAGAT
GAGTGGATACG -> AGTGGATACGT
ACTAATCTATT -> CTAATCTATTG
TTTGGCCCGCG -> TTGGCCCGCGA
GTCGCATGTCG -> TCGCATGTCGG
GTTCCAACTTT -> TTCCAACTTTA
TTAGGCACGAG -> TAGGCACGAGT
GGAGAGCATTC -> GAGAGCATTCA
CTTACGGTCCG -> TTACGGTCCGG
AAGACTGGCTA -> AGACTGGCTAA
TCTAGCGTTCT -> CTAGCGTTCTG
TACGTCATGGC -> ACGTCATGGCG
CGAGCCACTGA -> GAGCCACTGAA
ATTATTTCCTT -> TTATTTCCTTC
GAGTATTGTGC -> AGTATTGTGCC
ATACGGGGTCA -> TACGGGGTCAA
CGAGTGCCGAG -> GAGTGCCGAGA
GCTTAGTAATG -> CTTAGTAATGC
TCCAGTAGCAG -> CCAGTAGCAGC
GGGCTAGCTTG -> GGCTAGCTTGC
ACACGCTTTTC -> CACGCTTTTCT
TACGGGGCACG -> ACGGGGCACGC
TCGGCGCAAAT -> CGGCGCAAATC
CCGGGACAAAC -> CGGGACAAACT
GATACATACAG -> ATACATACAGA
TATTGCAAGCG -> ATTGCAAGCGT
GCTGTTCATTT -> CTGTTCATTTG
CTGGGCCGGCG -> TGGGCCGGCGA
GCATTTCCCGA -> CATTTCCCGAT
TTTCTTGGCCA -> TTCTTGGCCAT
GCGACGGTTCA -> CGACGGTTCAC
TACCCCACTAT -> ACCCCACTATG
ATTTCCTTCAT -> TTTCCTTCATC
ACGGCATTGCG -> CGGCATTGCGA
AGGCACGAGTG -> GGCACGAGTGG
TATTTCCTTCA -> ATTTCCTTCAT
GATGGACGATA -> ATGGACGATAT
CCAGAGGCTCG -> CAGAGGCTCGG
AGCCCAGCTCT -> GCCCAGCTCTA
ATTAGCTTGAT -> TTAGCTTGATG
CTGAGCAAAGC -> TGAGCAAAGCA
ACACTTCGACT -> CACTTCGACTG
AAGCCTTTTGC -> AGCCTTTTGCA
TAACTAATCTA -> AACTAATCTAT
GGTCGGCGCAA -> GTCGGCGCAAA
CCTTGTTTTTG -> CTTGTTTTTGA
TAGAGTTCGGA -> AGAGTTCGGAC
AGGGTCGGCGC -> GGGTCGGCGCA
GGGTCAAGAAT -> GGTCAAGAATG
GGTACGTTCGG -> GTACGTTCGGT
GTCTTAGCTCA -> TCTTAGCTCAT
TTTGACTTCGT -> TTGACTTCGTT
ACGATATTGGC -> CGATATTGGCC
TCTCTCTGAGC -> CTCTCTGAGCA
CAAAGGGTCGG -> AAAGGGTCGGC
TTAGCCCAGCT -> TAGCCCAGCTC
TTCCCGATAGC -> TCCCGATAGCG
AAAGGGTGAGG -> AAGGGTGAGGG
ACTTTATTCCT -> CTTTATTCCTT
TGTCCAGTAGC -> GTCCAGTAGCA
GCAACCATTAG -> CAACCATTAGT
GGACATACGTA -> GACATACGTAA
TACATACAGAT -> ACATACAGATG
CTCAGACGTCA -> TCAGACGTCAG
TTAGAGTTCGG -> TAGAGTTCGGA
TTCTACCCAAT -> TCTACCCAATT
TGGCTAACTCT -> GGCTAACTCTG
GTGGTACGTTC -> TGGTACGTTCG
TCCTCAGCCCA -> CCTCAGCCCAC
TCTTAATGGCC -> CTTAATGGCCA
TTAGAGATGTT -> TAGAGATGTTT
CGACTGCAACA -> GACTGCAACAT
AATCTATTGCG -> ATCTATTGCGG
CACAGATGCGT -> ACAGATGCGTC
GCATGCCGTAT -> CATGCCGTATG
TTGACGCATGC -> TGACGCATGCC
CCTCCTAAAGG -> CTCCTAAAGGG
GAACGCCTACG -> AACGCCTACGT
AAGCGGCGCAA -> AGCGGCGCAAA
CGGTACATCCC -> GGTACATCCCT
GGCACTCATCA -> GCACTCATCAC
CGATACATACA -> GATACATACAG
CTCTGCCTGGG -> TCTGCCTGGGC
GAAGTTCTAGC -> AAGTTCTAGCG
TGTTTAGGGAT -> GTTTAGGGATC
TGGGGCTCAGT -> GGGGCTCAGTG
ATTTTGCGTCT -> TTTTGCGTCTA
GTGAGGGTATA -> TGAGGGTATAG
ACTTCGACTGC -> CTTCGACTGCA
CCACTATGAAC -> CACTATGAACT
GGTCGCATGTC -> GTCGCATGTCG
TTACGACCTCC -> TACGACCTCCT
GATTGCATCCC -> ATTGCATCCCC
CCCATTCGGTT -> CCATTCGGTTT
AGGATTGCATC -> GGATTGCATCC
GTTTCTAAAGA -> TTTCTAAAGAA
ACAAACTGAGT -> CAAACTGAGTT
ATACGTCATGG -> TACGTCATGGC
GTGGATACGTC -> TGGATACGTCA
GACATACGTAA -> ACATACGTAAT
AATGGCCAACC -> ATGGCCAACCT
CCCGCGTGCCT -> CCGCGTGCCTT
CTAAAGAATTG -> TAAAGAATTGC
AGAATCCAATT -> GAATCCAATTA
CGAGAGTGGAT -> GAGAGTGGATA
CCGGTTTGGCC -> CGGTTTGGCCC
TAGCGTTCTGG -> AGCGTTCTGGC
TCATCACAGAC -> CATCACAGACA
ATCTCGCATAC -> TCTCGCATACC
GGCATAGTTTT -> GCATAGTTTTG
ATTAAGGGCAA -> TTAAGGGCAAG
CCGAGAGAATC -> CGAGAGAATCC
GCCAGCAATCC -> CCAGCAATCCG
GTATGGAGGCA -> TATGGAGGCAA
CTCTCTGAGCA -> TCTCTGAGCAA
GCGAAAGACCT -> CGAAAGACCTC
AGCAAATTTTG -> GCAAATTTTGC
ACTTCGTTCTG -> CTTCGTTCTGT
TAATGGTTGGG -> AATGGTTGGGG
ATTTCACCACG -> TTTCACCACGG
CAGACGGCGAG -> AGACGGCGAGA
GATGTTTTAGA -> ATGTTTTAGAG
ACCTGTTAGTT -> CCTGTTAGTTT
AAAGCAGATAC -> AAGCAGATACC
CCGATTGTTCA -> CGATTGTTCAC
TAATACGCTGA -> AATACGCTGAC
TACAATTATTT -> ACAATTATTTC
AACCAGGCACT -> ACCAGGCACTC
CCGAGTGCCGA -> CGAGTGCCGAG
ATTGGAGAGCA -> TTGGAGAGCAT
CAGCAATCCGA -> AGCAATCCGAT
GTCCTCGCTCT -> TCCTCGCTCTG
GTACGGGGCAC -> TACGGGGCACG
ACACGCACTGT -> CACGCACTGTC
GCTCGGCTTAG -> CTCGGCTTAGT
TTCAGTGTTGA -> TCAGTGTTGAC
GGGTATCGTTA -> GGTATCGTTAA
CAATTAGATCA -> AATTAGATCAC
TACCTAGTTAG -> ACCTAGTTAGC
CCCCGATTGTT -> CCCGATTGTTC
ACCGGTTTGGC -> CCGGTTTGGCC
AGTGGACATAC -> GTGGACATACG
ACTTCAGTGTT -> CTTCAGTGTTG
CATCACAGACA -> ATCACAGACAG
ATTGCGGAAAC -> TTGCGGAAACT
GGACGATATTG -> GACGATATTGG
GGGTATGGAGG -> GGTATGGAGGC
ACCACGGGAAA -> CCACGGGAAAG
CAGTCGGACTT -> AGTCGGACTTC
CGCATGCCGTA -> GCATGCCGTAT
AGTTCCAACTT -> GTTCCAACTTT
TGGGCCGGCGA -> GGGCCGGCGAA
CAATCTCGCAT -> AATCTCGCATA
CCGCGAGTCTC -> CGCGAGTCTCT
GACGATATTGG -> ACGATATTGGC
GCAAGACTGAT -> CAAGACTGATG
TCTAACCCCCA -> CTAACCCCCAT
GGGCTCAGTGT -> GGCTCAGTGTA
TGATGGACGAT -> GATGGACGATA
GAATCCAATTA -> AATCCAATTAG
CTCAGTGGACC -> TCAGTGGACCC
GCGGCTCGCTG -> CGGCTCGCTGT
TTTTATGTCGG -> TTTATGTCGGT
GTCCCCTTCAG -> TCCCCTTCAGA
AAGACTGATGG -> AGACTGATGGC
TTTGCGTCTAA -> TTGCGTCTAAC
ATTTCGCAAAG -> TTTCGCAAAGG
ATCTTCAACTT -> TCTTCAACTTA
CGGCTTAGTAA -> GGCTTAGTAAT
CACTCATAATG -> ACTCATAATGG
GTCGGACTTCA -> TCGGACTTCAG
TTGCATTCACG -> TGCATTCACGT
TAGTTTGTTCC -> AGTTTGTTCCG
CTTGCTGCGGA -> TTGCTGCGGAA
CGGCGCAAAGC -> GGCGCAAAGCG
CATAGATAATT -> ATAGATAATTG
CAAAGCAGATA -> AAAGCAGATAC
TGTTTTAGAGT -> GTTTTAGAGTT
CCCCACTATGA -> CCCACTATGAA
TCCTAAAGGGT -> CCTAAAGGGTC
CCCACTATGAA -> CCACTATGAAC
TGGTATCATAG -> GGTATCATAGA
CATTGCGATCG -> ATTGCGATCGA
GTCAGAACAGG -> TCAGAACAGGA
CACTGTTGACG -> ACTGTTGACGC
TATGTCTGGTC -> ATGTCTGGTCT
CATACGTAATA -> ATACGTAATAC
TTAGGGCACTG -> TAGGGCACTGT
ACTGAGCAAAG -> CTGAGCAAAGC
CCACAGGTCTT -> CACAGGTCTTA
ACATACCGTAC -> CATACCGTACA
TCGTTCTGTTT -> CGTTCTGTTTT
TCGTTAACGAG -> CGTTAACGAGA
GGAGTATTGTG -> GAGTATTGTGC
CTTAGTAATGC -> TTAGTAATGCA
AGAATGTCGGC -> GAATGTCGGCT
ATGTCGGCAAA -> TGTCGGCAAAA
TTCGAGTTTGG -> TCGAGTTTGGA
TCGGTATGTCT -> CGGTATGTCTG
TCACAGACAGA -> CACAGACAGAA
ATTTCGTCAGT -> TTTCGTCAGTC
TGCGGAATCTT -> GCGGAATCTTA
AGATGTTTTAG -> GATGTTTTAGA
TGTTCCGTACA -> GTTCCGTACAC
GGAGCATTTCC -> GAGCATTTCCC
TTCGTAACACT -> TCGTAACACTT
ACTCATCACAG -> CTCATCACAGA
GGCGGACGAGG -> GCGGACGAGGG
GTTGCATTGGG -> TTGCATTGGGA
TTTTGCTGCGC -> TTTGCTGCGCG
GGTCCTTACCT -> GTCCTTACCTA
ATGGCTTTTTT -> TGGCTTTTTTT
GACCCAACCCG -> ACCCAACCCGG
CACAATTCCGT -> ACAATTCCGTG
AAATTTTGCGT -> AATTTTGCGTC
ACCAATCTCGC -> CCAATCTCGCA
GACCTACCAAT -> ACCTACCAATC
TCGCTCTGTGT -> CGCTCTGTGTA
TCTGTTTTGGC -> CTGTTTTGGCA
TAGCGGGACTC -> AGCGGGACTCG
TACAGATGGGA -> ACAGATGGGAC
GTTCACTGTTG -> TTCACTGTTGA
TCGGTTTCTAA -> CGGTTTCTAAA
ACAGACAGAAA -> CAGACAGAAAA
GCATTGGGAAC -> CATTGGGAACA
CGCTGTTGCAT -> GCTGTTGCATT
TTCGCAAAGGG -> TCGCAAAGGGT
TGAGTGGACAT -> GAGTGGACATA
CGATTCGAGTT -> GATTCGAGTTT
ACAGGTCTTAG -> CAGGTCTTAGC
ATGGCGTGCTG -> TGGCGTGCTGT
ATTGCCGCGGA -> TTGCCGCGGAG
ACATATTGGAG -> CATATTGGAGA
GCGCAAAGCGG -> CGCAAAGCGGC
CCCACAGGTCT -> CCACAGGTCTT
TGCATTGGTGT -> GCATTGGTGTG
TTTTGGTCGCA -> TTTGGTCGCAT
TGCGATCGATG -> GCGATCGATGA
CAACCCGGGAC -> AACCCGGGACA
ACTCGCGACGG -> CTCGCGACGGT
TGGTCTCCAGC -> GGTCTCCAGCT
ATACCCCACTA -> TACCCCACTAT
CATACCCCCGA -> ATACCCCCGAT
ATAGACGGCTC -> TAGACGGCTCA
TCACGTCCTCG -> CACGTCCTCGC
ATGTCGGTATG -> TGTCGGTATGT
TAGCGACGACC -> AGCGACGACCT
AAGCGTATGAC -> AGCGTATGACC
CAAACAAACTG -> AAACAAACTGA
GGTACATCCCT -> GTACATCCCTC
TTAGATCACAT -> TAGATCACATT
TCCAACTTTAT -> CCAACTTTATT
GTTGACCCAAC -> TTGACCCAACC
ACTCTGCCTGG -> CTCTGCCTGGG
AGGTCGCGGGG -> GGTCGCGGGGC
TTCTCGGTTTG -> TCTCGGTTTGT
TGAACTGATAA -> GAACTGATAAG
AGGTCTTAGCT -> GGTCTTAGCTC
GGGCATTTCAC -> GGCATTTCACC
CCTTTGGTATC -> CTTTGGTATCA
CTGGCATAGTT -> TGGCATAGTTT
AATTATTTCCT -> ATTATTTCCTT
ACGGTTCACGG -> CGGTTCACGGC
CCCAATTAGAT -> CCAATTAGATC
CAAACTGAGTT -> AAACTGAGTTA
AAAGGGTCCTT -> AAGGGTCCTTA
GCGCGTACATC -> CGCGTACATCC
TGCCGTCTCAG -> GCCGTCTCAGT
TCGGCTTGGCG -> CGGCTTGGCGC
TACCCAATTAG -> ACCCAATTAGA
GACGTCAGAAC -> ACGTCAGAACA
ATATTGGCCCG -> TATTGGCCCGG
AACCTTGTTTT -> ACCTTGTTTTT
ACACAATTCCG -> CACAATTCCGT
CGTACACGCAC -> GTACACGCACT
GGAAAAAGGGT -> GAAAAAGGGTG
TTGCTGCGCGT -> TGCTGCGCGTA
CGTACATCCAC -> GTACATCCACC
TGGACGATATT -> GGACGATATTG
GCGCCATTGAT -> CGCCATTGATA
TGCTGTTCATT -> GCTGTTCATTT
GTATCATAGAC -> TATCATAGACG
GACTGCAACAT -> ACTGCAACATA
GCTCAGTGTAT -> CTCAGTGTATT
ACGGGGTCAAG -> CGGGGTCAAGA
CGGCGCAAATC -> GGCGCAAATCT
ATACAGATGGG -> TACAGATGGGA
GGTCCCCTTCA -> GTCCCCTTCAG
CTTCTCGGTTT -> TTCTCGGTTTG
TACGTGGGGGT -> ACGTGGGGGTA
CGCCTACGTGG -> GCCTACGTGGG
TTGACTTCGTT -> TGACTTCGTTC
AGACTGGCTAA -> GACTGGCTAAC
TGTCACATATT -> GTCACATATTG
GGCCATTCTTC -> GCCATTCTTCT
TTGCGATCGAT -> TGCGATCGATG
GAGTGGTACGT -> AGTGGTACGTT
CCTCAGCCCAC -> CTCAGCCCACA
AGATGCGTCCA -> GATGCGTCCAT
CCGTACACGCT -> CGTACACGCTT
TCATTTGTCCC -> CATTTGTCCCT
AACTTTATTCC -> ACTTTATTCCT
CACGCGGAGTT -> ACGCGGAGTTA
CCGTACACGCA -> CGTACACGCAC
GCATACGGGGT -> CATACGGGGTC
GGGTCCTTACC -> GGTCCTTACCT
GAGTTAGGGCA -> AGTTAGGGCAC
ACGGGAAAGCA -> CGGGAAAGCAA
TTGCATCCCCG -> TGCATCCCCGC
GGCTCGGCTTA -> GCTCGGCTTAG
CATCGAGCCAC -> ATCGAGCCACT
CGTCATGGCGT -> GTCATGGCGTG
ATACGTAATAC -> TACGTAATACG
AGACAGAAAAA -> GACAGAAAAAT
AAACTTCCTAC -> AACTTCCTACT
AACATACCGTA -> ACATACCGTAC
AAGGGTCCTTA -> AGGGTCCTTAC
ATTGGTGTGCA -> TTGGTGTGCAA
GACGAGCGCAG -> ACGAGCGCAGA
GTAATTGGTCT -> TAATTGGTCTC
TCGCATGTCGG -> CGCATGTCGGC
CTACCCAATTA -> TACCCAATTAG
CATTTCCCGAT -> ATTTCCCGATA
TCTAAAGAATT -> CTAAAGAATTG
CCCGCGACCTG -> CCGCGACCTGT
GCATTCACAGA -> CATTCACAGAT
GTTCACGGCAT -> TTCACGGCATT
CGCGTACATCC -> GCGTACATCCA
ATGCGTCCATA -> TGCGTCCATAG
GCAAACAAACT -> CAAACAAACTG
GATCGTCTACA -> ATCGTCTACAA
GCTTTTTTTTA -> CTTTTTTTTAT
ATGGACGATAT -> TGGACGATATT
GTTCTGGCTTG -> TTCTGGCTTGC
GGCTAACTCTG -> GCTAACTCTGC
AGTGGATACGT -> GTGGATACGTC
ATAGCGACGAC -> TAGCGACGACC
TCATTCTACCC -> CATTCTACCCA
TCCCCTTCAGA -> CCCCTTCAGAG
CGTGGGTTTTC -> GTGGGTTTTCG
TCACCACGGGA -> CACCACGGGAA
ATGCCCGGCCG -> TGCCCGGCCGG
TTCCTTCATCG -> TCCTTCATCGA
TGCGTCTAACC -> GCGTCTAACCC
ACATGCCCGGC -> CATGCCCGGCC
CATACAGATGG -> ATACAGATGGG
TTGGCGCCATT -> TGGCGCCATTG
CAAATTTTGCG -> AAATTTTGCGT
ACGTCAGAACA -> CGTCAGAACAG
GTGGGTTTTCG -> TGGGTTTTCGT
GGTCTTAGCTC -> GTCTTAGCTCA
CAAGACTGATG -> AAGACTGATGG
CGGAGCATTTC -> GGAGCATTTCC
CTTTTTTTTAT -> TTTTTTTTATG
GGACGAGGGCT -> GACGAGGGCTA
GAAAAATCGTC -> AAAAATCGTCT
TCGCATACGGG -> CGCATACGGGG
CCAGCAATCCG -> CAGCAATCCGA
TTTGGTATCAT -> TTGGTATCATA
GATGGCTTTTT -> ATGGCTTTTTT
TGGTACGTTCG -> GGTACGTTCGG
ATTGCATCCCC -> TTGCATCCCCG
GAGCATTTCCC -> AGCATTTCCCG
GGGTATAGAAC -> GGTATAGAACG
CATCCCCGCGA -> ATCCCCGCGAG
CTTCCTACTCG -> TTCCTACTCGC
GTGCCGTCTCA -> TGCCGTCTCAG
CCTGATAGCAA -> CTGATAGCAAA
CAGTTGCGGTA -> AGTTGCGGTAC
CGAGGGCTAGC -> GAGGGCTAGCT
GCTCTGTGTAC -> CTCTGTGTACC
TCGTCAGTCAG -> CGTCAGTCAGT
CGGTACGGGGC -> GGTACGGGGCA
GACTTCAGACG -> ACTTCAGACGG
TATTGTGCCGT -> ATTGTGCCGTC
TTTTTTTATGT -> TTTTTTATGTC
CTCAGCCCACA -> TCAGCCCACAG
AGTATTGTGCC -> GTATTGTGCCG
AGAGTGGATAC -> GAGTGGATACG
TCATAATGGTT -> CATAATGGTTG
TTGGTGTGCAA -> TGGTGTGCAAA
AGTTAGGGCAC -> GTTAGGGCACT
CACCACGGGAA -> ACCACGGGAAA
GGCCCGCGACC -> GCCCGCGACCT
CGATGATGGAC -> GATGATGGACG
CTATGAACTGA -> TATGAACTGAT
TAACTCTGCCT -> AACTCTGCCTG
TTTAGCACGAG -> TTAGCACGAGA
CGACCTCCTAA -> GACCTCCTAAA
AAAATCGTCTG -> AAATCGTCTGG
GAGTGCCGAGA -> AGTGCCGAGAG
ATAGAACGCCT -> TAGAACGCCTA
GTCCAGTAGCA -> TCCAGTAGCAG
GGTCTCCAGCT -> GTCTCCAGCTA
ACCCTGATAGC -> CCCTGATAGCA
TCCTTACCTAG -> CCTTACCTAGT
TCCTACTCGCA -> CCTACTCGCAT
GCACTGTTGCA -> CACTGTTGCAT
TCAGTGGACCC -> CAGTGGACCCA
TCGAGCCACTG -> CGAGCCACTGA
TTGATGGCCAA -> TGATGGCCAAT
GGGGTCAAGAA -> GGGTCAAGAAT
TACCCCCGATT -> ACCCCCGATTG
CTGCCTGGGCC -> TGCCTGGGCCG
ACATCCACCTA -> CATCCACCTAC
GTACACGCTTT -> TACACGCTTTT
GCTAACTAATC -> CTAACTAATCT
GCTTGGCGCCA -> CTTGGCGCCAT
CATTGGTGTGC -> ATTGGTGTGCA
GTTTTGGCATA -> TTTTGGCATAC
GCATTCACGTC -> CATTCACGTCC
TACACTTGGGA -> ACACTTGGGAT
CTGGTCTGAAG -> TGGTCTGAAGC
GGCTCGCTGTT -> GCTCGCTGTTG
TCATGGCGTGC -> CATGGCGTGCT
TATGACCCGCG -> ATGACCCGCGT
AGTTCGGACTT -> GTTCGGACTTC
CCTACCAATCT -> CTACCAATCTC
CTGCGCGTACA -> TGCGCGTACAT
TCATCGAGCCA -> CATCGAGCCAC
GTTCGGTACAT -> TTCGGTACATC
CTCCCAAGCGG -> TCCCAAGCGGC
GAGCATTCACA -> AGCATTCACAG
GGTCGCGGGGC -> GTCGCGGGGCA
TTTATGTCGGT -> TTATGTCGGTA
GATAGCGACGA -> ATAGCGACGAC
GGTCCGGAAAA -> GTCCGGAAAAA
GGTCAAGAATG -> GTCAAGAATGT
CTTACCTAGTT -> TTACCTAGTTA
GTAACACTTCG -> TAACACTTCGA
AAATCACTGAG -> AATCACTGAGC
ATATTGGAGAG -> TATTGGAGAGC
GACGCATGCCG -> ACGCATGCCGT
TCGGACTTCAG -> CGGACTTCAGT,CGGACTTCAGA
ATTTGTCCCTG -> TTTGTCCCTGG
TGGAGGCAAGA -> GGAGGCAAGAC
AGACGGCGAGA -> GACGGCGAGAG
ACCTACCAATC -> CCTACCAATCT
GCGATCGATGA -> CGATCGATGAT
ACTTCCTACTC -> CTTCCTACTCG
ATTCTACCCAA -> TTCTACCCAAT
CATTTGTCCCT -> ATTTGTCCCTG
TCTACCCAATT -> CTACCCAATTA
ATGCATTGGTG -> TGCATTGGTGT
TCGCAAAGGGT -> CGCAAAGGGTC
GTCGCGGGGCA -> TCGCGGGGCAT
CGTTCGGTACA -> GTTCGGTACAT
GTTTAGGGATC -> TTTAGGGATCC
ACTTACGGTCC -> CTTACGGTCCG
GTCGGCAAAAG -> TCGGCAAAAGT
CTCGCATACGG -> TCGCATACGGG
ACCTCCTAAAG -> CCTCCTAAAGG
AGCGGGACTCG -> GCGGGACTCGC
AATCACTGAGC -> ATCACTGAGCA
CAGAGGCTCGG -> AGAGGCTCGGC
GAGCAACCATT -> AGCAACCATTA
ACCCCACTATG -> CCCCACTATGA
CTACGTGGGGG -> TACGTGGGGGT
TGCCTGGGCCG -> GCCTGGGCCGG
GACCAGGAGTA -> ACCAGGAGTAT
AGCACGAGAAA -> GCACGAGAAAA
TTTTTATGTCG -> TTTTATGTCGG
CTCATAGGACC -> TCATAGGACCT
ACCTTTGGTAT -> CCTTTGGTATC
TCTCTGAGCAA -> CTCTGAGCAAC
GTCTCCAGCTA -> TCTCCAGCTAA
GCGAGTCTCTC -> CGAGTCTCTCT
AGTGTATTGCA -> GTGTATTGCAA
TGCTGCGGAAT -> GCTGCGGAATC
GGATCGGCGGA -> GATCGGCGGAC
CCCTTCAGAGT -> CCTTCAGAGTT
ACCCCCGATTG -> CCCCCGATTGT
CGCGACCTGTT -> GCGACCTGTTA
TTGGGTCATTC -> TGGGTCATTCT
GACTGGCTAAC -> ACTGGCTAACT
CTATAGCGGGA -> TATAGCGGGAC
GGATACGTCAT -> GATACGTCATG
CACTGTCCAGT -> ACTGTCCAGTA
TGTCGGTATGT -> GTCGGTATGTC
CTACCAATCTC -> TACCAATCTCG
CAACCATTAGT -> AACCATTAGTC
TTGCTCCCAAG -> TGCTCCCAAGC
TTGCTGCGGAA -> TGCTGCGGAAT
TTCAGACGGCG -> TCAGACGGCGA
CCTACACTTGG -> CTACACTTGGG
CGCACTGTCCA -> GCACTGTCCAG
GATCGGCGGAC -> ATCGGCGGACG
TTGCAAGCGTA -> TGCAAGCGTAT
GGTACGGGGCA -> GTACGGGGCAC
ATAATTGGGTC -> TAATTGGGTCA
AACCATTAGTC -> ACCATTAGTCG
TTCACGGCATT -> TCACGGCATTG
TAACGAGACGG -> AACGAGACGGT
CCATTGATAAC -> CATTGATAACT
CAGAAAAATCG -> AGAAAAATCGT
CTTCAGTGTTG -> TTCAGTGTTGA
TGGACATACGT -> GGACATACGTA
TCAGCCCACAG -> CAGCCCACAGG
AAAAGTTCCAA -> AAAGTTCCAAC
TCCCTCAGACG -> CCCTCAGACGT
TCTTGGCCATT -> CTTGGCCATTC
ATCGTCTGGAG -> TCGTCTGGAGT
TAGACGGCTCA -> AGACGGCTCAA
GAGACGGTTAT -> AGACGGTTATT
CGTGCTGTTCA -> GTGCTGTTCAT
CGGCGGACGAG -> GGCGGACGAGG
GGATTGCATCC -> GATTGCATCCC
CGGCTTGGCGC -> GGCTTGGCGCC
ATGGCCAATTA -> TGGCCAATTAA
CAAGCGGCGCA -> AAGCGGCGCAA
GAATTGCCGCG -> AATTGCCGCGG
CAAAAGTTCCA -> AAAAGTTCCAA
TAAGACTGGCT -> AAGACTGGCTA
TTTTTTTTATG -> TTTTTTTATGT
CTTAATGGCCA -> TTAATGGCCAA
TCGTCTGGAGT -> CGTCTGGAGTG
TCAGTCGGACT -> CAGTCGGACTT
GGAAGTTTAGA -> GAAGTTTAGAG
CTCAAGGTCGC -> TCAAGGTCGCG
GCAAAAGTTCC -> CAAAAGTTCCA
CCTGGGCCGGC -> CTGGGCCGGCG
TCCACCTACAC -> CCACCTACACT
CAGTGTATTGC -> AGTGTATTGCA
CCATAGATAAT -> CATAGATAATT
TGATAACTCAG -> GATAACTCAGG
GATAACTCAGG -> ATAACTCAGGT
ATGCCGTATGC -> TGCCGTATGCA
CACAGACAGAA -> ACAGACAGAAA
CTCGGTTTGTC -> TCGGTTTGTCA
GATGATTACGA -> ATGATTACGAC
AATTGGTCTCC -> ATTGGTCTCCA
GAGGCTCGGCT -> AGGCTCGGCTT
GCATGTTTAGG -> CATGTTTAGGG
GGCAAGTGAAG -> GCAAGTGAAGC
AATGTCGGCTT -> ATGTCGGCTTG
CATTGATAACT -> ATTGATAACTC
CAGATACCCTG -> AGATACCCTGA
CCCGATTGTTC -> CCGATTGTTCA
ATTCGGTTTCT -> TTCGGTTTCTA
CCTCAGACGTC -> CTCAGACGTCA
CCAATTAAGGG -> CAATTAAGGGC
CTGTTTTGGCA -> TGTTTTGGCAT
AGTGCCGAGAG -> GTGCCGAGAGA
TATTTCGTCAG -> ATTTCGTCAGT
AATGGTTGGGG -> ATGGTTGGGGC
TCAGGTGGACG -> CAGGTGGACGA
CAGTAGCAGCC -> AGTAGCAGCCA
TCACTGTTGAC -> CACTGTTGACG
GACTTCAGTGT -> ACTTCAGTGTT
AGGTGGACGAG -> GGTGGACGAGC
AGAAAATCACT -> GAAAATCACTG
AACGAGACGGT -> ACGAGACGGTT
TCTTCTCGGTT -> CTTCTCGGTTT
GGCTTGCTCCC -> GCTTGCTCCCA
ACTTTACAGTA -> CTTTACAGTAT
TTTGCACGTAA -> TTGCACGTAAT
TGATGGCTTTT -> GATGGCTTTTT
TGTATTGCAAG -> GTATTGCAAGC
CACTGAGCAAA -> ACTGAGCAAAG
AAGGGTCGGCG -> AGGGTCGGCGC
CGTGCCTTTCC -> GTGCCTTTCCT
GTTCATTTGTC -> TTCATTTGTCC
CTGTTGACGCA -> TGTTGACGCAT
ATTGGGAACAC -> TTGGGAACACA
GAACACAATTC -> AACACAATTCC
CCATTCGGTTT -> CATTCGGTTTC
GTGGGGGTATC -> TGGGGGTATCG
GCCGAGAGAAT -> CCGAGAGAATC
CGATAGCGACG -> GATAGCGACGA
CGTCCATAGAT -> GTCCATAGATA
GGGCCGGCGAA -> GGCCGGCGAAA
GCCATTCTTCT -> CCATTCTTCTC
GCATACCCCCG -> CATACCCCCGA
GAGAGCATTCA -> AGAGCATTCAC
TATCGTTAACG -> ATCGTTAACGA
GTGAAGCCTTT -> TGAAGCCTTTT
TGGGATCGGCG -> GGGATCGGCGG
AGCAACCATTA -> GCAACCATTAG
CAAACTTCCTA -> AAACTTCCTAC
AACCCGGGACA -> ACCCGGGACAA
CGCCATTGATA -> GCCATTGATAA
GGCATACCCCA -> GCATACCCCAC
AGATAATTGGG -> GATAATTGGGT
CAATTAGCTTG -> AATTAGCTTGA
TCGGTACATCC -> CGGTACATCCC
ACCCGGGACAA -> CCCGGGACAAA
CTGAGCAACCA -> TGAGCAACCAT
TGGCCAATTAA -> GGCCAATTAAG
AACTGATAAGA -> ACTGATAAGAC
CACTATGAACT -> ACTATGAACTG
GGTGTGCAAAC -> GTGTGCAAACA
ACGGTTATTTG -> CGGTTATTTGA
CTAACTCTGCC -> TAACTCTGCCT
ATGGGACCGGT -> TGGGACCGGTT
CCGTATGCATT -> CGTATGCATTG
TTCTAGCGTTC -> TCTAGCGTTCT
TGACCCAACCC -> GACCCAACCCG
AGTCGATTCGA -> GTCGATTCGAG
CCGATGATTAC -> CGATGATTACG
ACGAGCGCAGA -> CGAGCGCAGAT
CTTGGCCATTC -> TTGGCCATTCT
TGTCGGCAAAA -> GTCGGCAAAAG
GAGCAAAGCAG -> AGCAAAGCAGA
GCGAGAGTGGA -> CGAGAGTGGAT
TGCAACATACC -> GCAACATACCG
TCGCGACGGTT -> CGCGACGGTTC
TGGGTCATTCT -> GGGTCATTCTA
AATGCAACTTT -> ATGCAACTTTA
TTGCACGTAAT -> TGCACGTAATT
CTCTGAGCAAC -> TCTGAGCAACC
AGACTGATGGC -> GACTGATGGCT
GCGACCTGTTA -> CGACCTGTTAG
CTTCAACTTAC -> TTCAACTTACG
GTCTGGAGTGG -> TCTGGAGTGGG
CGGGACAAACT -> GGGACAAACTT
GGACCGGTTTG -> GACCGGTTTGG
CCTTACCTAGT -> CTTACCTAGTT
TGCGACCAGGA -> GCGACCAGGAG
GCATTGCGATC -> CATTGCGATCG
CCGATAGCGAC -> CGATAGCGACG
GGTTTTCGTAA -> GTTTTCGTAAC
AAGTTCTAGCG -> AGTTCTAGCGT
GGGACTCGCGA -> GGACTCGCGAC
