GGGTCGAAACC -> GGTCGAAACCT
TGCGCTTGAAG -> GCGCTTGAAGC
TACGACGGACG -> ACGACGGACGG
TCTGCTCTAAA -> CTGCTCTAAAG
CGAGCTGCTGC -> GAGCTGCTGCC
CTACGTAGTAT -> TACGTAGTATG
ACGTATCGATA -> CGTATCGATAG
GTTCCCGTCAT -> TTCCCGTCATA
CCTTCTTCGGG -> CTTCTTCGGGC
CCACCTTCTTC -> CACCTTCTTCG
TAGTTAAAGTG -> AGTTAAAGTGT
TATTATTTCAT -> ATTATTTCATC
AGCAAGCCACG -> GCAAGCCACGA
GGTAACAAATA -> GTAACAAATAA
GCAGATTGGGT -> CAGATTGGGTC
ATGACTTGGGG -> TGACTTGGGGA
ACACTGGGTAC -> CACTGGGTACT
TGCCTTAGTCT -> GCCTTAGTCTA
ACTTCCTCCAG -> CTTCCTCCAGC
AAAATAACATC -> AAATAACATCA
ATCGGGTGGCG -> TCGGGTGGCGT
GCAAGCAAGCA -> CAAGCAAGCAC
CGAGGGCCTCT -> GAGGGCCTCTT
CTTCCTCCAGC -> TTCCTCCAGCC
CATCCATCGGG -> ATCCATCGGGT
GATCGCGCGAG -> ATCGCGCGAGG
AACATCACTGT -> ACATCACTGTA
AAGGTAGATGG -> AGGTAGATGGA
CAAAGTGGTGT -> AAAGTGGTGTA
ATTGATTAAGC -> TTGATTAAGCC
CTACAAACTCG -> TACAAACTCGA
ATGAAATCAAT -> TGAAATCAATA
CGTTATTTTGT -> GTTATTTTGTG
GGTAGAGCTAG -> GTAGAGCTAGT
ACCATTAATTC -> CCATTAATTCT
CATAAGGTGTC -> ATAAGGTGTCA
ACGACGGACGG -> CGACGGACGGA
TCAACATAAAC -> CAACATAAACA
GGCCTGGGCCG -> GCCTGGGCCGC
GAGCGCAGTGA -> AGCGCAGTGAC
CGGTGGTACAC -> GGTGGTACACT
GGTTTGGAACG -> GTTTGGAACGG
TAGAGCTAGTC -> AGAGCTAGTCG
AAATGAAATCA -> AATGAAATCAA
CGGTCTTATGG -> GGTCTTATGGA
GCCTGGGCCGC -> CCTGGGCCGCA
TATCGGTCAGT -> ATCGGTCAGTG
GAGGACCCACC -> AGGACCCACCA
GGGTTAGTCGA -> GGTTAGTCGAA
TAGTCTACTTC -> AGTCTACTTCC
AGACGAACGTA -> GACGAACGTAT
CAGTGTAATGT -> AGTGTAATGTT
TTTCCACTACC -> TTCCACTACCT
TGTTATATGAC -> GTTATATGACT
GTCTCCACGCA -> TCTCCACGCAT
TATTGTTATAT -> ATTGTTATATG
GTGCTTATCCT -> TGCTTATCCTC
TCAACTAGAAG -> CAACTAGAAGG
AAGATAGTGTT -> AGATAGTGTTA
CCATTGGCGCA -> CATTGGCGCAC
CGCAGGGGTTC -> GCAGGGGTTCT
TACAAACTCGA -> ACAAACTCGAC
ACCTTCTTCGG -> CCTTCTTCGGG
ATGAGTCTTAC -> TGAGTCTTACA
AATCAGATCCA -> ATCAGATCCAG
CTAGAAGGTAG -> TAGAAGGTAGA
ACTGTATCTCC -> CTGTATCTCCG
AGGTACATTGT -> GGTACATTGTC
GAAGCAACCGC -> AAGCAACCGCT
GCCCGTTCCCG -> CCCGTTCCCGT
GGGACAAGGCA -> GGACAAGGCAC
CCTGGGGCAAT -> CTGGGGCAATA
GTGTGCCTGAC -> TGTGCCTGACG
CAGCGGAAGCA -> AGCGGAAGCAA
TACGCGGCATT -> ACGCGGCATTT
TCAGACCAACT -> CAGACCAACTC
AACCTTCCGTT -> ACCTTCCGTTC
CTGCAAGATAG -> TGCAAGATAGT
TCTTACATCGG -> CTTACATCGGC
AGTGCAGCAGA -> GTGCAGCAGAT
AGCGGAAGCAA -> GCGGAAGCAAC
AGCCGATGCCT -> GCCGATGCCTT
TTCTAAGAATA -> TCTAAGAATAC
ACCGGTGAGGG -> CCGGTGAGGGT
ACAATATGCGC -> CAATATGCGCG
AAGAGTCAGCG -> AGAGTCAGCGG
TGCCGTATAGT -> GCCGTATAGTT
TCTGAGGACAA -> CTGAGGACAAT
TGTACCATTTA -> GTACCATTTAC
GATAACCTTCC -> ATAACCTTCCG
CTACCAAGAGC -> TACCAAGAGCA
ATGCCATTACT -> TGCCATTACTG
AACCTGCAAGA -> ACCTGCAAGAT
GATCAGCCGAT -> ATCAGCCGATG
CGGATGCCCGA -> GGATGCCCGAG
GTAACAAATAA -> TAACAAATAAG
GATAGTAAATG -> ATAGTAAATGT
GGTGAGGGTAT -> GTGAGGGTATA
CTAGAAGGCCG -> TAGAAGGCCGC
TACTTCCTCCA -> ACTTCCTCCAG
GGTTAAAAGTG -> GTTAAAAGTGC
AAGGTGTCAAC -> AGGTGTCAACA
ATCGCCCCATT -> TCGCCCCATTC
ATCTCCGAGGG -> TCTCCGAGGGC
ACGCATTCTGA -> CGCATTCTGAG
ATCCTCTATCT -> TCCTCTATCTA
GAGTCAGCGGA -> AGTCAGCGGAA
GTGTTACAACA -> TGTTACAACAT
CGCGTTTCCAC -> GCGTTTCCACT
CACTAATTGTA -> ACTAATTGTAA
GGGACTAGAAG -> GGACTAGAAGG
CGTATTATTTC -> GTATTATTTCA
CGAATCGCCCC -> GAATCGCCCCA
GTTACAACGCA -> TTACAACGCAG
AGGCGCCATTG -> GGCGCCATTGG
ACGGGCAGGGT -> CGGGCAGGGTC
AGTGTAATGTT -> GTGTAATGTTC
ATCGGCGGTTT -> TCGGCGGTTTG
ATTCTAAGACG -> TTCTAAGACGA
CGAACGTATCG -> GAACGTATCGA
CATGAACAGCT -> ATGAACAGCTC
AGCGGGGTTAG -> GCGGGGTTAGT
TTGGGCGGATG -> TGGGCGGATGC
GGACAATATGC -> GACAATATGCG
GTCACTGCCTT -> TCACTGCCTTA
GGCGAATCCTC -> GCGAATCCTCT
TGTTCGCAAGC -> GTTCGCAAGCA
TATGGAGCGCA -> ATGGAGCGCAG
AATACTGGCAC -> ATACTGGCACC
GAAGAGTCAGC -> AAGAGTCAGCG
CTTCGATTGGA -> TTCGATTGGAG
AATAGCGATGT -> ATAGCGATGTG
CGGAAGCAACG -> GGAAGCAACGC
TACGTAGTATG -> ACGTAGTATGC
CAGGGTTGTGT -> AGGGTTGTGTG
GGCCGTTATTT -> GCCGTTATTTT
GACATTTTATG -> ACATTTTATGA
AACTCTACGAC -> ACTCTACGACG
TTCTTGAATAG -> TCTTGAATAGC
GTACATTGTCA -> TACATTGTCAC
TTGTGGGGTTA -> TGTGGGGTTAA
AACAGCTCGCG -> ACAGCTCGCGT
ATTAAGCCGCG -> TTAAGCCGCGC
AAATGTGGACA -> AATGTGGACAC
TTATCCTCCCA -> TATCCTCCCAC
GTCAGTGTTAC -> TCAGTGTTACA
ATGATCACTAA -> TGATCACTAAT
CGCGTGTGCCT -> GCGTGTGCCTG
GGCAGGGTCCT -> GCAGGGTCCTT
ATTATTTCATC -> TTATTTCATCT
TGAGGGTATAG -> GAGGGTATAGA
CGCCCCATTCC -> GCCCCATTCCA
TTGTTATATGA -> TGTTATATGAC
TAAACACCATT -> AAACACCATTT
GAAACCTATGC -> AAACCTATGCC
TGCCTTTAGAT -> GCCTTTAGATT
ACTGCTTTTGT -> CTGCTTTTGTG
TGCTAACCTGC -> GCTAACCTGCA
GTTTCCACTAC -> TTTCCACTACC
CACATAAGGTG -> ACATAAGGTGT
TACTCGGGACT -> ACTCGGGACTA
AGCAACCGCTA -> GCAACCGCTAC
TTTCATCTAGA -> TTCATCTAGAA
GGTAATAAACC -> GTAATAAACCC
CGGAACAGATC -> GGAACAGATCG
TAAAGTGTCGT -> AAAGTGTCGTC
GGTGTAGTCGG -> GTGTAGTCGGA
TGCTGCCCGTA -> GCTGCCCGTAT
TAGACATTTTA -> AGACATTTTAT
ATCACCTGGGG -> TCACCTGGGGC
AAGATTGGAGT -> AGATTGGAGTA
ATGCCTATCGG -> TGCCTATCGGT
ATAACATCTTC -> TAACATCTTCT
CCCGAGTATAT -> CCGAGTATATT
TCTACAAACTC -> CTACAAACTCG
GTATTATTTCA -> TATTATTTCAT
ATTCTGAGGAC -> TTCTGAGGACA
GTCGTCAACGG -> TCGTCAACGGG
ATTTTGTGTAC -> TTTTGTGTACC
AACGCATAATA -> ACGCATAATAC
CGATTGGAGGA -> GATTGGAGGAC
CGAACATGTTA -> GAACATGTTAC
ACCATGAACAG -> CCATGAACAGC
ACCAGTACGAC -> CCAGTACGACC
GTTCTAAGAAT -> TTCTAAGAATA
ATGACACTGGG -> TGACACTGGGT
ATCGGTCAGTG -> TCGGTCAGTGT
AATAGCAATTT -> ATAGCAATTTA
GCTTTTGTGGG -> CTTTTGTGGGG
ATGTTACGCGT -> TGTTACGCGTT
GGCCGACCACA -> GCCGACCACAC
ATCTAATCAGA -> TCTAATCAGAT
TCCAAAATACG -> CCAAAATACGC
ATGAGGTGTTG -> TGAGGTGTTGG
TTCTGAGGACA -> TCTGAGGACAA
TCTATCTAATC -> CTATCTAATCA
CAATAGCGATG -> AATAGCGATGT
CCAGAGGCGCA -> CAGAGGCGCAG
GAGGTGTTGGC -> AGGTGTTGGCC
TCTGAGGTCGA -> CTGAGGTCGAG
ATGGATACCCA -> TGGATACCCAA
CTTCGGGCGGC -> TTCGGGCGGCC
TTTAGATTGTG -> TTAGATTGTGT
TCTCTGCTCTA -> CTCTGCTCTAA
TGTGGGGTTAA -> GTGGGGTTAAA
CTGGGCCGCAC -> TGGGCCGCACT
TTCCACTACCT -> TCCACTACCTA
TAAGATTGGAG -> AAGATTGGAGT
ATAATACTGGC -> TAATACTGGCA
GCCCGATTGGG -> CCCGATTGGGC
ATCCTCCCACC -> TCCTCCCACCT
GTATCTCCGAG -> TATCTCCGAGG
CAGGCGACATC -> AGGCGACATCC
TTTTGTGTACC -> TTTGTGTACCA
TTAGATTGTGT -> TAGATTGTGTA
AGCCAGGAGGA -> GCCAGGAGGAC
AATTGTAAACG -> ATTGTAAACGG
ATCACTAATTG -> TCACTAATTGT
GTGTACCATTT -> TGTACCATTTA
TTCTAAGACGA -> TCTAAGACGAA
GGTTGGAGCGC -> GTTGGAGCGCG
CGTTCTCGGTA -> GTTCTCGGTAG
CGATGCCTTTA -> GATGCCTTTAG
CGATAGTAAAT -> GATAGTAAATG
TTCCCGTCATA -> TCCCGTCATAA
CAAAATACGCG -> AAAATACGCGT
CAATTTATCTA -> AATTTATCTAG
ACAACGCAGGC -> CAACGCAGGCG
AGGTTGGAGCG -> GGTTGGAGCGC
TTGGAGGACCC -> TGGAGGACCCA
CTTCCGTTCTA -> TTCCGTTCTAA
GAACAGATCGG -> AACAGATCGGC
ACAAGGCACCA -> CAAGGCACCAT
AGGAGGACCAT -> GGAGGACCATA
CCATGAGTCTT -> CATGAGTCTTA
AGACATTTTAT -> GACATTTTATG
GTAAATGTGGA -> TAAATGTGGAC
ACGCTTACGCG -> CGCTTACGCGG
GGGTAACAAAT -> GGTAACAAATA
AGTGCTACGTA -> GTGCTACGTAG
TGGGCGGATGC -> GGGCGGATGCC
AGTCAGCGGAA -> GTCAGCGGAAG
CGGGTCGAAAC -> GGGTCGAAACC
TATGCTAACCT -> ATGCTAACCTG
ATAACATCACT -> TAACATCACTG
ACTCAGACCAA -> CTCAGACCAAC
CCATCTCACCA -> CATCTCACCAG
TGAGTCTTACA -> GAGTCTTACAT
TGTGTACCATT -> GTGTACCATTT
TGACTTGGGGA -> GACTTGGGGAT
CTAAGAATACG -> TAAGAATACGG
TAATTGTAAAC -> AATTGTAAACG
TAATACTGGCA -> AATACTGGCAC
GTATCAAAAAT -> TATCAAAAATA
CATTCTGAGGA -> ATTCTGAGGAC
GTGCAGCAGAT -> TGCAGCAGATT
TTACTGGTTGC -> TACTGGTTGCC
AGTTAAAGTGT -> GTTAAAGTGTC
CTAATCAGATC -> TAATCAGATCC
TACTGGTTGCC -> ACTGGTTGCCG
CCACGCATTCT -> CACGCATTCTG
TTCCCGAATAC -> TCCCGAATACG
TTGTCACTGCC -> TGTCACTGCCT
AGCTAACGCAT -> GCTAACGCATA
AGAATACGGTG -> GAATACGGTGG
TACGTACTCGG -> ACGTACTCGGG
CCGATGCCTTT -> CGATGCCTTTA
GGTACATTGTC -> GTACATTGTCA
ACGCGTTTCCA -> CGCGTTTCCAC
TCGATTGGAGG -> CGATTGGAGGA
GTAATGTTCCA -> TAATGTTCCAA
GGGCAATAAGA -> GGCAATAAGAT
AATACGGTGGT -> ATACGGTGGTA
ACGGTGGTACA -> CGGTGGTACAC
TTAATTCTAAG -> TAATTCTAAGA
TGTATGAGGTG -> GTATGAGGTGT
CCCGGAACAGA -> CCGGAACAGAT
CTTGCTGCCCG -> TTGCTGCCCGT
TGGATACCCAA -> GGATACCCAAC
TATAGACGTCA -> ATAGACGTCAA
GCCGTCCCGGA -> CCGTCCCGGAA
CGAGAAGCAAC -> GAGAAGCAACC
TGACGCTTACG -> GACGCTTACGC
TAAGATTCCCG -> AAGATTCCCGA
CTCTGCTCTAA -> TCTGCTCTAAA
AGTCGACGAGC -> GTCGACGAGCT
CGCGGGCGAAT -> GCGGGCGAATC
ATTGGGTCTCC -> TTGGGTCTCCA
TGTCCCAGAGG -> GTCCCAGAGGC
CCATCGGGTGG -> CATCGGGTGGC
ACAAAGTGGTG -> CAAAGTGGTGT
TAAGACGAACG -> AAGACGAACGT
TCCATCTCACC -> CCATCTCACCA
TGTCACTGCCT -> GTCACTGCCTT
AGGGGTTCTTG -> GGGGTTCTTGA
AAGAGCAAGCC -> AGAGCAAGCCA
TTGGGTCTCCA -> TGGGTCTCCAC
CGCACCTCCAC -> GCACCTCCACG
GCACCTCCACG -> CACCTCCACGG
ATCGAGAAGCA -> TCGAGAAGCAA
GGACCATATGC -> GACCATATGCC
ACCCAACCTCT -> CCCAACCTCTG
ACCGCTACTTC -> CCGCTACTTCG
ACGAGCTGCTG -> CGAGCTGCTGC
TGAATAGCAAT -> GAATAGCAATT
CTCGGTAGAGC -> TCGGTAGAGCT
GCACCGGTGAG -> CACCGGTGAGG
GGCTATTGCCC -> GCTATTGCCCG
AATACGCGTGA -> ATACGCGTGAA
CACAAAGTGGT -> ACAAAGTGGTG
GTGTAGTCGGA -> TGTAGTCGGAG
GCGGCATTTAC -> CGGCATTTACT
GGCATTTACTG -> GCATTTACTGT
GTCTTATGGAG -> TCTTATGGAGC
GAGGGTATAGA -> AGGGTATAGAC
TTATCTAGATG -> TATCTAGATGC
TTGATTAAGCC -> TGATTAAGCCG
AGATCCAGTGT -> GATCCAGTGTA
GGGATCGCGCG -> GGATCGCGCGA
TTGAAGCGCGC -> TGAAGCGCGCT
ACCTCCACGGT -> CCTCCACGGTG
ATGTTCCAAAA -> TGTTCCAAAAT
TTAAGAAAGCA -> TAAGAAAGCAA
GTAGTATGCTA -> TAGTATGCTAA
CCCAACGAACC -> CCAACGAACCA
CTCCGACCGGG -> TCCGACCGGGT
TAATAGCGTGG -> AATAGCGTGGG
ACCGGGTCGAA -> CCGGGTCGAAA
TTGCCCGTTCC -> TGCCCGTTCCC
TCCACGCATTC -> CCACGCATTCT
CTTACGCGGCA -> TTACGCGGCAT
GTGGCGTATTA -> TGGCGTATTAT
CACCATTTTAC -> ACCATTTTACA
ATATGACTTGG -> TATGACTTGGG
TCAAAAATAAC -> CAAAAATAACA
CCAGTACGACC -> CAGTACGACCC
GTAGGTCTAAG -> TAGGTCTAAGA
GTAGATGGATA -> TAGATGGATAC
TGGAGTATCAA -> GGAGTATCAAA
ACAGCTCGCGT -> CAGCTCGCGTG
TGTCGTCAACG -> GTCGTCAACGG
CTATTGCCCGT -> TATTGCCCGTT
CTTACTACCAA -> TTACTACCAAG
CCATTAATTCT -> CATTAATTCTA
CTGGTGTTCGC -> TGGTGTTCGCA
CGGGCGAATCC -> GGGCGAATCCT
TGAGGTGTTGG -> GAGGTGTTGGC
ACACCATTTTA -> CACCATTTTAC
TATCACCTGGG -> ATCACCTGGGG
TTCCGTTCTAA -> TCCGTTCTAAG
TAGAAGGCCGC -> AGAAGGCCGCA
TCGGTAGAGCT -> CGGTAGAGCTA
AAGTGGTGTAG -> AGTGGTGTAGT
TATGATCACTA -> ATGATCACTAA
AATTTATCTAG -> ATTTATCTAGA
GTCAACGGGCA -> TCAACGGGCAG
CTCAGACCAAC -> TCAGACCAACT
TATCTAATCAG -> ATCTAATCAGA
TGCCATTACTG -> GCCATTACTGG
CATTGTCACTG -> ATTGTCACTGC
TCGAACATGTT -> CGAACATGTTA
CTCCAGCCCGA -> TCCAGCCCGAT
AACCGCTACTT -> ACCGCTACTTC
GCGATTAAGAA -> CGATTAAGAAA
AGGACTGGGAC -> GGACTGGGACA
TGTTACAACAT -> GTTACAACATG
GCCGCGCGGAA -> CCGCGCGGAAG
AATAGCGTGGG -> ATAGCGTGGGT
ATTGTCACTGC -> TTGTCACTGCC
TGGGGATCAGC -> GGGGATCAGCC
AAAATCGAGAA -> AAATCGAGAAG
TGAGGCGCCAT -> GAGGCGCCATT
AATCGAGAAGC -> ATCGAGAAGCA
TATGACTTGGG -> ATGACTTGGGG
TTATGGAGCGC -> TATGGAGCGCA
TGCCCGAGTAT -> GCCCGAGTATA
GAGGGGCCCTA -> AGGGGCCCTAC
TGCTCTAAAGT -> GCTCTAAAGTA
GCAGTGACGCT -> CAGTGACGCTT
GGAACAGATCG -> GAACAGATCGG
CTACAATTGGG -> TACAATTGGGT
CGGGCGGCCGT -> GGGCGGCCGTT
ACCATTTACTA -> CCATTTACTAA
CTAACCTGCAA -> TAACCTGCAAG
GATTGGGTCTC -> ATTGGGTCTCC
GTCTGGTGTTC -> TCTGGTGTTCG
CTTGAAGCGCG -> TTGAAGCGCGC
TTGTGTAGGTC -> TGTGTAGGTCT
GCGCCATTGGC -> CGCCATTGGCG
GCTGCTGCCGT -> CTGCTGCCGTC
GGGTTGTGTGC -> GGTTGTGTGCT
CCGGAACAGAT -> CGGAACAGATC
ACTCCTGTGCT -> CTCCTGTGCTT
GTATCGATAGT -> TATCGATAGTA
GCGTGGGTTGT -> CGTGGGTTGTT
CATCTCTCCGA -> ATCTCTCCGAC
ACGAACCATGA -> CGAACCATGAG
TTTGAGGCGCC -> TTGAGGCGCCA
CCATGAACAGC -> CATGAACAGCT
CGGAGGCCTTG -> GGAGGCCTTGC
TGGGTACTCGG -> GGGTACTCGGT
CGATTAAGAAA -> GATTAAGAAAG
CGAGGTACATT -> GAGGTACATTG
CGCGAGGTACA -> GCGAGGTACAT
GCGGAAGCGGG -> CGGAAGCGGGG
GCAAGATAGTG -> CAAGATAGTGT
TATAGTTAAAG -> ATAGTTAAAGT
CGCTAATAACA -> GCTAATAACAT
AACAAATAAGG -> ACAAATAAGGT
CAACGCCCTAC -> AACGCCCTACT
GCCCGTATGAT -> CCCGTATGATC
CCAACGAACCA -> CAACGAACCAT
TACTACCAAGA -> ACTACCAAGAG
CGGCATTTACT -> GGCATTTACTG
GTGTTGGCCTG -> TGTTGGCCTGG
GTACCATTTAC -> TACCATTTACT
CTCACCAGTAC -> TCACCAGTACG
AATAACATCAC -> ATAACATCACT
TGGCGCACCTC -> GGCGCACCTCC
CTAAGATTGGA -> TAAGATTGGAG
AGAGTCAGCGG -> GAGTCAGCGGA
CGGGACTAGAA -> GGGACTAGAAG
ACTAATAGCGT -> CTAATAGCGTG
ACTAGAAGGTA -> CTAGAAGGTAG
ATCGATAGTAA -> TCGATAGTAAA
CGGGGTTAGTC -> GGGGTTAGTCG
GATTAAGAAAG -> ATTAAGAAAGC
GCCACGAATCG -> CCACGAATCGC
TGGGACAAGGC -> GGGACAAGGCA
AGATTGTGTAG -> GATTGTGTAGG
ATCTTCTCTGC -> TCTTCTCTGCT
AAGGTTGGAGC -> AGGTTGGAGCG
GTATTGTTATA -> TATTGTTATAT
AATGTGGACAC -> ATGTGGACACA
CGGAGGGGCCC -> GGAGGGGCCCT
TACAACATGAC -> ACAACATGACA
TATTTCATCTA -> ATTTCATCTAG
AACCTCTGAGG -> ACCTCTGAGGT
ACCATTTTACA -> CCATTTTACAT
GGGGTTCTTGA -> GGGTTCTTGAA
CACTGTATCTC -> ACTGTATCTCC
GGACCCACCAT -> GACCCACCATC
CCTGACGTTCT -> CTGACGTTCTC
TGCTCATAGAC -> GCTCATAGACA
CCTCTTGCTGC -> CTCTTGCTGCC
CATCTAGAACC -> ATCTAGAACCT
TGCCCGTTCCC -> GCCCGTTCCCG
GTCTTACATCG -> TCTTACATCGG
TTGGGGATCAG -> TGGGGATCAGC
TGTAATGTTCC -> GTAATGTTCCA
GGCGCAGGGGT -> GCGCAGGGGTT
ATACCCAACCT -> TACCCAACCTC
GCATTCTGAGG -> CATTCTGAGGA
TCTAAGACGAA -> CTAAGACGAAC
AACTAGAAGGT -> ACTAGAAGGTA
AGATTGGGTCT -> GATTGGGTCTC
CACTAAGCTAA -> ACTAAGCTAAC
CAACGGGCAGG -> AACGGGCAGGG
TCCCGAATACG -> CCCGAATACGT
GAGCTGCTGCC -> AGCTGCTGCCG
TTGAGGCGCCA -> TGAGGCGCCAT
CAACATGACAC -> AACATGACACT
GCAAGGGATCG -> CAAGGGATCGC
TGGCCTGGGCC -> GGCCTGGGCCG
GGATCGCGCGA -> GATCGCGCGAG
GGGGTTAGTCG -> GGGTTAGTCGA
ACCTATCACCT -> CCTATCACCTG
CGCCCTGCAGG -> GCCCTGCAGGG
AAGCAACCGCT -> AGCAACCGCTA
TAAGAAAGCAA -> AAGAAAGCAAG
CCCGTTCCCGT -> CCGTTCCCGTC
TGCCGTCCCGG -> GCCGTCCCGGA
TGCAAGATAGT -> GCAAGATAGTG
GGGATCAGCCG -> GGATCAGCCGA
AAACCTATGCC -> AACCTATGCCA
GCGCACCTCCA -> CGCACCTCCAC
ATGATGTAGTG -> TGATGTAGTGC
GCGCAGGGGTT -> CGCAGGGGTTC
TATTGATTAAG -> ATTGATTAAGC
ACATGCGCTTG -> CATGCGCTTGA
TAGACGTCAAC -> AGACGTCAACT
GCTTATCCTCC -> CTTATCCTCCC
TTACGCGTTTC -> TACGCGTTTCC
CTGAGGACAAT -> TGAGGACAATA
GATCGGCGGTT -> ATCGGCGGTTT
GAACATGTTAC -> AACATGTTACG
GCAATAAGATT -> CAATAAGATTC
AATTGGGTAAT -> ATTGGGTAATA
GCCGATGCCTT -> CCGATGCCTTT
ATTGTTATATG -> TTGTTATATGA
CTGATAACCTT -> TGATAACCTTC
CTCCACGCATT -> TCCACGCATTC
AAGCCACGAAT -> AGCCACGAATC
TCCACTACCTA -> CCACTACCTAT
ATTGTAAACGG -> TTGTAAACGGT
ATGCCTTTAGA -> TGCCTTTAGAT
CATTACTGGTT -> ATTACTGGTTG
CTACGACGGAC -> TACGACGGACG
TTGTTATAGTT -> TGTTATAGTTT
CCAGGAGGACC -> CAGGAGGACCA
TGATCACTAAT -> GATCACTAATT
TGTAGTGCAGC -> GTAGTGCAGCA
ACTGTTAGATG -> CTGTTAGATGT
GGGTCTCCACG -> GGTCTCCACGC
AGGCGCAGGGG -> GGCGCAGGGGT
GGACTGGGACA -> GACTGGGACAA
TACTCAGACCA -> ACTCAGACCAA
CATTTTACATG -> ATTTTACATGC
ACGTCAACTAG -> CGTCAACTAGA
TTGGAGTATCA -> TGGAGTATCAA
TCCTGTGCTTA -> CCTGTGCTTAT
ATCAAAAATAA -> TCAAAAATAAC
TCCCAGAGGCG -> CCCAGAGGCGC
ACTGGGACAAG -> CTGGGACAAGG
GTTTGGAACGG -> TTTGGAACGGG
CTGGCACCGGT -> TGGCACCGGTG
TAACATCTTCT -> AACATCTTCTC
ACCAACTCTAC -> CCAACTCTACG
GGTAGATGGAT -> GTAGATGGATA
AACGCAGGCGA -> ACGCAGGCGAC
TCAGCGGAAGC -> CAGCGGAAGCA
AAATACGCGTG -> AATACGCGTGA
TGCTGCCGTCC -> GCTGCCGTCCC
GTTGCCGTATA -> TTGCCGTATAG
TAACAAATAAG -> AACAAATAAGG
GGACGGAGGGG -> GACGGAGGGGC
ACATCCATCGG -> CATCCATCGGG
GGGCTATTGCC -> GGCTATTGCCC
GGTTAGTCGAA -> GTTAGTCGAAC
AGTGACGCTTA -> GTGACGCTTAC
CACCTCCACGG -> ACCTCCACGGT
ACTTGGGGATC -> CTTGGGGATCA
TACTAATAGCG -> ACTAATAGCGT
TCAGCCGATGC -> CAGCCGATGCC
ACGTACTCGGG -> CGTACTCGGGA
CAACTCTACGA -> AACTCTACGAC
GTTCGCAAGCA -> TTCGCAAGCAA
CACCTTCTTCG -> ACCTTCTTCGG
TCTAGTATTGT -> CTAGTATTGTT
GAGCAAGCCAC -> AGCAAGCCACG
GGATGCCCGAG -> GATGCCCGAGT
CGTACTCGGGA -> GTACTCGGGAC
CTTTTGTGGGG -> TTTTGTGGGGT
GGCCTTGCAGG -> GCCTTGCAGGG
CGAGGACTGGG -> GAGGACTGGGA
GCAATTTATCT -> CAATTTATCTA
CAGTGTTACAA -> AGTGTTACAAC
CAAACTCGACC -> AAACTCGACCA
GATGCCTTTAG -> ATGCCTTTAGA
GATTGGGCGGA -> ATTGGGCGGAT
TACTTCGATTG -> ACTTCGATTGG
GCCCTACTCAG -> CCCTACTCAGA
TGTTGGCCTGG -> GTTGGCCTGGG
GCCCTGCAGGG -> CCCTGCAGGGT
AGTATTGTTAT -> GTATTGTTATA
CCGTATAGTTA -> CGTATAGTTAA
TACGCGTGAAG -> ACGCGTGAAGA
GCCCCATTCCA -> CCCCATTCCAT
ATCGGCGCCCT -> TCGGCGCCCTG
ACGGGGGTAAC -> CGGGGGTAACA
ATACGGTGGTA -> TACGGTGGTAC
TGTTCCAAAAT -> GTTCCAAAATA
TTCCTCCAGCC -> TCCTCCAGCCC
CACTACTCCTG -> ACTACTCCTGT
GTGGTACACTA -> TGGTACACTAC
TATCAAAAATA -> ATCAAAAATAA
CCGAGGGCCTC -> CGAGGGCCTCT
CTCGGGACTAG -> TCGGGACTAGA
AACGGGGGTAA -> ACGGGGGTAAC
TACATGCGCTT -> ACATGCGCTTG
GTGCTCATAGA -> TGCTCATAGAC
CAAGAGCAAGC -> AAGAGCAAGCC
TACGCGTTTCC -> ACGCGTTTCCA
CGAATACGTAC -> GAATACGTACT
ATCTAGAACCT -> TCTAGAACCTC
GCAGGGTTGTG -> CAGGGTTGTGT
CGTCAACTAGA -> GTCAACTAGAA
CACACATAAGG -> ACACATAAGGT
TCTACGACGGA -> CTACGACGGAC
ACACATAAGGT -> CACATAAGGTG
TGTAGGTCTAA -> GTAGGTCTAAG
CATCGGGTGGC -> ATCGGGTGGCG
TCGACCATTAA -> CGACCATTAAT
CTGACGTTCTC -> TGACGTTCTCG
ACTGGGTACTC -> CTGGGTACTCG
TCACTGCCTTA -> CACTGCCTTAG
AGTCGGAGGCC -> GTCGGAGGCCT
GTGTGCTCATA -> TGTGCTCATAG
CGCTACTTCGA -> GCTACTTCGAT
TTGGAGCGCGG -> TGGAGCGCGGG
CAGGGTCCTTA -> AGGGTCCTTAC
TTTGTGTACCA -> TTGTGTACCAT
GGGCCCTACAA -> GGCCCTACAAT
CGCCATTGGCG -> GCCATTGGCGC
ATTACTGGTTG -> TTACTGGTTGC
AAAAATAACAT -> AAAATAACATC
GTATAGTTAAA -> TATAGTTAAAG
TGCTACGTAGT -> GCTACGTAGTA
AGCTGCTGCCG -> GCTGCTGCCGT
TAATTCTAAGA -> AATTCTAAGAC
GGTGGGCTATT -> GTGGGCTATTG
AATCGCCCCAT -> ATCGCCCCATT
TGACGTTCTCG -> GACGTTCTCGG
TGAAGAGTCAG -> GAAGAGTCAGC
ATACGCGTGAA -> TACGCGTGAAG
TACCAAGAGCA -> ACCAAGAGCAA
TCGATAGTAAA -> CGATAGTAAAT
GGGTACTCGGT -> GGTACTCGGTC
AGAGCAAGCCA -> GAGCAAGCCAC
GCACCATGAAC -> CACCATGAACA
GGGCGAATCCT -> GGCGAATCCTC
TATTTTGTGTA -> ATTTTGTGTAC
ATCACTGTATC -> TCACTGTATCT
TAATAAACCCG -> AATAAACCCGG
GCAGCAGATTG -> CAGCAGATTGG
CGGCCGTTATT -> GGCCGTTATTT
CTTATCCTCCC -> TTATCCTCCCA
ACCTGGGGCAA -> CCTGGGGCAAT
GTGCTACGTAG -> TGCTACGTAGT
GAATACGGTGG -> AATACGGTGGT
GTCGAACATGT -> TCGAACATGTT
CCGTCATAATC -> CGTCATAATCT
GTGTAGGTCTA -> TGTAGGTCTAA
TCACCTGGGGC -> CACCTGGGGCA
ACATTGTCACT -> CATTGTCACTG
GAACAGCTCGC -> AACAGCTCGCG
TCTAAGAATAC -> CTAAGAATACG
GCAACCGCTAC -> CAACCGCTACT
CTAATAACATC -> TAATAACATCT
ACATAAACACC -> CATAAACACCA
TGGTACACTAC -> GGTACACTACT
GTTAGTCGAAC -> TTAGTCGAACA
GGCGGCCGTTA -> GCGGCCGTTAT
CGTATAGTTAA -> GTATAGTTAAA
GACTGGGACAA -> ACTGGGACAAG
ACCTGCAAGAT -> CCTGCAAGATA
AAGCAACGCCC -> AGCAACGCCCT
GACTAGAAGGC -> ACTAGAAGGCC
GTCATAATCTA -> TCATAATCTAT
TGACACTGGGT -> GACACTGGGTA
AAATAAGGTTG -> AATAAGGTTGG
GAACGGGGGTA -> AACGGGGGTAA
GGCGGTTTGGA -> GCGGTTTGGAA
GGCGTATTATT -> GCGTATTATTT
GATCACTAATT -> ATCACTAATTG
TCCTCCAGCCC -> CCTCCAGCCCG
AACCCGGTCTA -> ACCCGGTCTAG
GCACTAAGCTA -> CACTAAGCTAA
TGTAGTCGGAG -> GTAGTCGGAGG
CTTTAGATTGT -> TTTAGATTGTG
CATCGGCGCCC -> ATCGGCGCCCT
ATGGAGCGCAG -> TGGAGCGCAGT
CATTTACTGTT -> ATTTACTGTTA
CATCACTGTAT -> ATCACTGTATC
GCGGGCGAATC -> CGGGCGAATCC
TTGGCGCACCT -> TGGCGCACCTC
GACGGACGGAG -> ACGGACGGAGG
GGACAAGGCAC -> GACAAGGCACC
AAGCAAGGGAT -> AGCAAGGGATC
CAAGCAAGCAC -> AAGCAAGCACA
TACAATTGGGT -> ACAATTGGGTA
ATAACCTTCCG -> TAACCTTCCGT
CATAATCTATA -> ATAATCTATAA
TTTGGAACGGG -> TTGGAACGGGG
TCTTCTCTGCT -> CTTCTCTGCTC
TGGGTCTCCAC -> GGGTCTCCACG
CGTCCCGGAAC -> GTCCCGGAACA
AGCGATGTGTC -> GCGATGTGTCC
TGGTTGCCGTA -> GGTTGCCGTAT
CAACGAACCAT -> AACGAACCATG
ACTCGGGACTA -> CTCGGGACTAG
TCACCAGTACG -> CACCAGTACGA
CACTACCTATC -> ACTACCTATCA
AGGGTCCTTAC -> GGGTCCTTACT
GTGACGCTTAC -> TGACGCTTACG
GGTCCTTACTA -> GTCCTTACTAC
TACCCAACCTC -> ACCCAACCTCT
TGTCAACATAA -> GTCAACATAAA
GGGCGGCCGTT -> GGCGGCCGTTA
CGCATAATACT -> GCATAATACTG
AGGGTATAGAC -> GGGTATAGACG
CACCGGTGAGG -> ACCGGTGAGGG
CATCTTCTCTG -> ATCTTCTCTGC
AGATTCCCGAA -> GATTCCCGAAT
TACCTATCACC -> ACCTATCACCT
GTTGGCCTGGG -> TTGGCCTGGGC
AGGACAATATG -> GGACAATATGC
ATTGGAGTATC -> TTGGAGTATCA
AACGCCCTACT -> ACGCCCTACTC
CCGTATGATCA -> CGTATGATCAC
CGCGCTAATAA -> GCGCTAATAAC
CACGCATTCTG -> ACGCATTCTGA
ATGTAGTGCAG -> TGTAGTGCAGC
TCGGGACTAGA -> CGGGACTAGAA
AATCCTCTATC -> ATCCTCTATCT
GGTCTAGTATT -> GTCTAGTATTG
CCGCGCGGAAG -> CGCGCGGAAGC
AACTCGACCAT -> ACTCGACCATT
GAGGGCCTCTT -> AGGGCCTCTTG
GAGAAGCAACC -> AGAAGCAACCG
CTGTGCTTATC -> TGTGCTTATCC
CTTCTTCGGGC -> TTCTTCGGGCG
ACGTCTGGTGT -> CGTCTGGTGTT
ATAGCGTGGGT -> TAGCGTGGGTT
GACCATATGCC -> ACCATATGCCT
CTAAAGTACGT -> TAAAGTACGTC
GGAGCGCAGTG -> GAGCGCAGTGA
AAAGTGGTGTA -> AAGTGGTGTAG
ATGCGCTTGAA -> TGCGCTTGAAG
GGGGTTAAAAG -> GGGTTAAAAGT
CAGTGACGCTT -> AGTGACGCTTA
AGATGGATACC -> GATGGATACCC
ATCGCGCGAGG -> TCGCGCGAGGT
GATCCAGTGTA -> ATCCAGTGTAA
TCGCGCGAGGT -> CGCGCGAGGTA
TGCAGGGTTGT -> GCAGGGTTGTG
ATGCGGCCGAC -> TGCGGCCGACC
AGTAAATGTGG -> GTAAATGTGGA
CCAAAATACGC -> CAAAATACGCG
CAGATCGGCGG -> AGATCGGCGGT
TTGCCGTATAG -> TGCCGTATAGT
GGTTCTTGAAT -> GTTCTTGAATA
CTCCGAGGGCC -> TCCGAGGGCCT
CCTTACTACCA -> CTTACTACCAA
CGACCACACAT -> GACCACACATA
CGACGGACGGA -> GACGGACGGAG
GATGTAGTGCA -> ATGTAGTGCAG
GTCAGCGGAAG -> TCAGCGGAAGC
CTCATAGACAT -> TCATAGACATT
CAAGCCACGAA -> AAGCCACGAAT
GTATGCTAACC -> TATGCTAACCT
TATATTGATTA -> ATATTGATTAA
CTCTATCTAAT -> TCTATCTAATC
GAGTATATTGA -> AGTATATTGAT
GTATATTGATT -> TATATTGATTA
AAGTGTCGTCA -> AGTGTCGTCAA
ATACTGGCACC -> TACTGGCACCG
TAGTTTGAGGC -> AGTTTGAGGCG
CTGGGGCAATA -> TGGGGCAATAA
AGACCAACTCT -> GACCAACTCTA
ATGCTAACCTG -> TGCTAACCTGC
TGGAACGGGGG -> GGAACGGGGGT
TTCATCTAGAA -> TCATCTAGAAC
CAACCTCTGAG -> AACCTCTGAGG
GGGCGGATGCC -> GGCGGATGCCC
ATCTCTCCGAC -> TCTCTCCGACC
GGGCCTCTTGC -> GGCCTCTTGCT
CCATATGCCTA -> CATATGCCTAT
TCGCGTGTGCC -> CGCGTGTGCCT
TAAAGTACGTC -> AAAGTACGTCT
CGGTTTGGAAC -> GGTTTGGAACG
GAAGCAACGCC -> AAGCAACGCCC
CATAGACATTT -> ATAGACATTTT
ACGTAGTATGC -> CGTAGTATGCT
CCTACTCAGAC -> CTACTCAGACC
GTGTCGTCAAC -> TGTCGTCAACG
CAACGCAGGCG -> AACGCAGGCGA
GATGGATACCC -> ATGGATACCCA
ACTACCAAGAG -> CTACCAAGAGC
TCGGCGCCCTG -> CGGCGCCCTGC
GCTAACCTGCA -> CTAACCTGCAA
AACACCATTTT -> ACACCATTTTA
GTAGTGCAGCA -> TAGTGCAGCAG
TGGAGGACCCA -> GGAGGACCCAC
TCTTGCTGCCC -> CTTGCTGCCCG
TGTTAGATGTA -> GTTAGATGTAT
CAGGGGTTCTT -> AGGGGTTCTTG
ACTTCGATTGG -> CTTCGATTGGA
CCCACCTTCTT -> CCACCTTCTTC
TTAAAAGTGCT -> TAAAAGTGCTA
TCGTCAACGGG -> CGTCAACGGGC
CGGTCAGTGTT -> GGTCAGTGTTA
TGGGCTATTGC -> GGGCTATTGCC
GGTTGTTATAG -> GTTGTTATAGT
GCGCGGGCGAA -> CGCGGGCGAAT
GAGCGCGGGCG -> AGCGCGGGCGA
GGGTTAAAAGT -> GGTTAAAAGTG
ATTGGCGCACC -> TTGGCGCACCT
AACCATGAGTC -> ACCATGAGTCT
TCGGTCTTATG -> CGGTCTTATGG
AGGTCTAAGAT -> GGTCTAAGATT
CGAACCATGAG -> GAACCATGAGT
TGTGCCTGACG -> GTGCCTGACGT
CTATCACCTGG -> TATCACCTGGG
AAGCAAGCACA -> AGCAAGCACAG
GGTCTCCACGC -> GTCTCCACGCA
TTACTGTTAGA -> TACTGTTAGAT
TCATAATCTAT -> CATAATCTATA
AAAAAAATCGA -> AAAAAATCGAG
TAATCTATAAA -> AATCTATAAAA
TCGAGGACTGG -> CGAGGACTGGG
GGACTAGAAGG -> GACTAGAAGGC
AGCTGATAACC -> GCTGATAACCT
GTAAACGGTAT -> TAAACGGTATA
AGAAAGCAAGG -> GAAAGCAAGGG
TACTGTTAGAT -> ACTGTTAGATG
GAAGCGCGCTA -> AAGCGCGCTAA
CCCCATTCCAT -> CCCATTCCATC
TAGTCGGAGGC -> AGTCGGAGGCC
TACGACCCCAA -> ACGACCCCAAC
GTTACGCGTTT -> TTACGCGTTTC
AATAACATCTT -> ATAACATCTTC
TTGGGTAATAA -> TGGGTAATAAA
CAACATAAACA -> AACATAAACAC
ACTACTCCTGT -> CTACTCCTGTG
TTGTAAACGGT -> TGTAAACGGTA
GGCCCTACAAT -> GCCCTACAATT
AGTGTCGTCAA -> GTGTCGTCAAC
GGTGTCAACAT -> GTGTCAACATA
GAGGTACATTG -> AGGTACATTGT
CGATGTGTCCC -> GATGTGTCCCA
TGCGGCCGACC -> GCGGCCGACCA
TTTACTGTTAG -> TTACTGTTAGA
CTAGTATTGTT -> TAGTATTGTTA
AGATCGGCGGT -> GATCGGCGGTT
TAAACGGTATA -> AAACGGTATAA
GACATCCATCG -> ACATCCATCGG
CGGAAGCGGGG -> GGAAGCGGGGT
TCCTCTATCTA -> CCTCTATCTAA
CATAATACTGG -> ATAATACTGGC
GCCGCACTGCT -> CCGCACTGCTT
GAATCGCCCCA -> AATCGCCCCAT
ACGACCCCAAC -> CGACCCCAACG
ATAAACCCGGT -> TAAACCCGGTC
GCGTTTCCACT -> CGTTTCCACTA
CGCTTACGCGG -> GCTTACGCGGC
GCAACGCCCTA -> CAACGCCCTAC
TAGATGCGGCC -> AGATGCGGCCG
CTCCACGGTGG -> TCCACGGTGGG
ATCAGATCCAG -> TCAGATCCAGT
CGCGGCATTTA -> GCGGCATTTAC
ACCATGAGTCT -> CCATGAGTCTT
AATAAGATTCC -> ATAAGATTCCC
GTTGTTATAGT -> TTGTTATAGTT
AATGTTCCAAA -> ATGTTCCAAAA
GTCGACGAGCT -> TCGACGAGCTG
AGCAGATTGGG -> GCAGATTGGGT
GTTCCAAAATA -> TTCCAAAATAC
GCTTGAAGCGC -> CTTGAAGCGCG
CACTGGGTACT -> ACTGGGTACTC
GCCGCACTAAG -> CCGCACTAAGC
AGCGCAGTGAC -> GCGCAGTGACG
CTGTTAGATGT -> TGTTAGATGTA
GGCACCATGAA -> GCACCATGAAC
CGGACGGAGGG -> GGACGGAGGGG
CCATTTTACAT -> CATTTTACATG
GGTACTCGGTC -> GTACTCGGTCT
AGGCACCATGA -> GGCACCATGAA
TAGATTGTGTA -> AGATTGTGTAG
GGCACCGGTGA -> GCACCGGTGAG
ATAGACGTCAA -> TAGACGTCAAC
TGGGGCAATAA -> GGGGCAATAAG
AGGCCTTGCAG -> GGCCTTGCAGG
TATATGACTTG -> ATATGACTTGG
GAGGCGCCATT -> AGGCGCCATTG
GAAATCAATAG -> AAATCAATAGC
TGTGGACACAA -> GTGGACACAAA
ATCTATAAAAA -> TCTATAAAAAA
ACCACACATAA -> CCACACATAAG
AAATAACATCA -> AATAACATCAC
GGCCGCACTAA -> GCCGCACTAAG
GTCTAGTATTG -> TCTAGTATTGT
CCCTGCAGGGT -> CCTGCAGGGTT
GGACACAAAGT -> GACACAAAGTG
TGCAGCAGATT -> GCAGCAGATTG
GGTGTTCGCAA -> GTGTTCGCAAG
CGTTTCCACTA -> GTTTCCACTAC
GTCGAAACCTA -> TCGAAACCTAT
AGGACCATATG -> GGACCATATGC
TGTGCTTATCC -> GTGCTTATCCT
GCAGGCGACAT -> CAGGCGACATC
ACGCAGGCGAC -> CGCAGGCGACA
CGACATCCATC -> GACATCCATCG
GCTCGCGTGTG -> CTCGCGTGTGC
CGACCATTAAT -> GACCATTAATT
CAATAAGATTC -> AATAAGATTCC
CTACTCCTGTG -> TACTCCTGTGC
TGGGTTGTTAT -> GGGTTGTTATA
TCGAAACCTAT -> CGAAACCTATG
ATGTATGAGGT -> TGTATGAGGTG
TTACTACCAAG -> TACTACCAAGA
GTTATATGACT -> TTATATGACTT
TCACTGTATCT -> CACTGTATCTC
CTCGGTCTTAT -> TCGGTCTTATG
ATCAGCCGATG -> TCAGCCGATGC
GTACTCGGTCT -> TACTCGGTCTT
ATAAATGAAAT -> TAAATGAAATC
TAGTCGAACAT -> AGTCGAACATG
ACAATTGGGTA -> CAATTGGGTAA
CACGAATCGCC -> ACGAATCGCCC
AGGCGACATCC -> GGCGACATCCA
AGGTGTTGGCC -> GGTGTTGGCCT
AGATAGTGTTA -> GATAGTGTTAC
CAACTAGAAGG -> AACTAGAAGGT
CATGCGCTTGA -> ATGCGCTTGAA
GCGGCCGACCA -> CGGCCGACCAC
CGTCTGGTGTT -> GTCTGGTGTTC
TCTCACCAGTA -> CTCACCAGTAC
ACTCTACGACG -> CTCTACGACGG
GCAGGGGTTCT -> CAGGGGTTCTT
CGATTGGGCGG -> GATTGGGCGGA
CCGCACTAAGC -> CGCACTAAGCT
AACATGACACT -> ACATGACACTG
TAATAACATCT -> AATAACATCTT
GTCGGAGGCCT -> TCGGAGGCCTT
TACTCGGTCTT -> ACTCGGTCTTA
AACGGGCAGGG -> ACGGGCAGGGT
AAGCTAACGCA -> AGCTAACGCAT
TCCGACCGGGT -> CCGACCGGGTC
TTAGTCTACTT -> TAGTCTACTTC
CCAAGAGCAAG -> CAAGAGCAAGC
TGGTGTTCGCA -> GGTGTTCGCAA
ATAAACACCAT -> TAAACACCATT
AGAAGGTAGAT -> GAAGGTAGATG
CAGCAGATTGG -> AGCAGATTGGG
TCTATAAAAAA -> CTATAAAAAAA
GACAAGGCACC -> ACAAGGCACCA
TAAATGAAATC -> AAATGAAATCA
ATGTGGACACA -> TGTGGACACAA
CTCTCCGACCG -> TCTCCGACCGG
ATTCCATCTCA -> TTCCATCTCAC
CCGGTGAGGGT -> CGGTGAGGGTA
GACCAACTCTA -> ACCAACTCTAC
AGGGATCGCGC -> GGGATCGCGCG
GGGGATCAGCC -> GGGATCAGCCG
AACGGTATAAA -> ACGGTATAAAT
CTAACGCATAA -> TAACGCATAAT
ATTTTACATGC -> TTTTACATGCG
CGCTTGAAGCG -> GCTTGAAGCGC
CGCATTCTGAG -> GCATTCTGAGG
CCATTACTGGT -> CATTACTGGTT
TGAACAGCTCG -> GAACAGCTCGC
GATGCCCGAGT -> ATGCCCGAGTA
ACCCACCATCT -> CCCACCATCTC
ACGCCCTACTC -> CGCCCTACTCA
ATTAAGAAAGC -> TTAAGAAAGCA
TGCCTGACGTT -> GCCTGACGTTC
GTGAAGAGTCA -> TGAAGAGTCAG
ACCAAGAGCAA -> CCAAGAGCAAG
AAAAATCGAGA -> AAAATCGAGAA
TCAGATCCAGT -> CAGATCCAGTG
CAATATGCGCG -> AATATGCGCGA
TATCTCCGAGG -> ATCTCCGAGGG
GAAGCGGGGTT -> AAGCGGGGTTA
CGACCCCAACG -> GACCCCAACGA
GGGTAATAAAC -> GGTAATAAACC
TTTGTGGGGTT -> TTGTGGGGTTA
CCTATCGGTCA -> CTATCGGTCAG
GGGGGTAACAA -> GGGGTAACAAA
CCCAACCTCTG -> CCAACCTCTGA
TGGGCCGCACT -> GGGCCGCACTA
AGCTCGCGTGT -> GCTCGCGTGTG
GTTTGAGGCGC -> TTTGAGGCGCC
ATAGTTTGAGG -> TAGTTTGAGGC
TTAGATGTATG -> TAGATGTATGA
ATAGTAAATGT -> TAGTAAATGTG
TGCCTATCGGT -> GCCTATCGGTC
CATGAGTCTTA -> ATGAGTCTTAC
TGTGCTCATAG -> GTGCTCATAGA
AGTCTACTTCC -> GTCTACTTCCT
GCGGATGCCCG -> CGGATGCCCGA
CTGCCGTCCCG -> TGCCGTCCCGG
TCCGTTCTAAG -> CCGTTCTAAGA
TGCTTTTGTGG -> GCTTTTGTGGG
CCAACTCTACG -> CAACTCTACGA
TTACAACGCAG -> TACAACGCAGG
TTGTGTGCTCA -> TGTGTGCTCAT
TCCTTACTACC -> CCTTACTACCA
TCGACGAGCTG -> CGACGAGCTGC
TGATTAAGCCG -> GATTAAGCCGC
GATTGGAGGAC -> ATTGGAGGACC
AATAAGGTTGG -> ATAAGGTTGGA
CACAGCCAGGA -> ACAGCCAGGAG
CCACGAATCGC -> CACGAATCGCC
CCAGCCCGATT -> CAGCCCGATTG
CGAAACCTATG -> GAAACCTATGC
ATTTATCTAGA -> TTTATCTAGAT
GCTAATAACAT -> CTAATAACATC
GCGGCCGTTAT -> CGGCCGTTATT
ACCCGGTCTAG -> CCCGGTCTAGT
TATAGTTTGAG -> ATAGTTTGAGG
CCTGTGCTTAT -> CTGTGCTTATC
AAAGTGCTACG -> AAGTGCTACGT
AGGGGCCCTAC -> GGGGCCCTACA
ATTTACTGTTA -> TTTACTGTTAG
CCGTTCTAAGA -> CGTTCTAAGAA
TCTCTCCGACC -> CTCTCCGACCG
AATATGCGCGA -> ATATGCGCGAT
ATAAGGTGTCA -> TAAGGTGTCAA
TATAAAAAAAA -> ATAAAAAAAAT
GTTATTTTGTG -> TTATTTTGTGT
GGCGCCATTGG -> GCGCCATTGGC
TGCTTATCCTC -> GCTTATCCTCC
TGAAATCAATA -> GAAATCAATAG
GTGGACACAAA -> TGGACACAAAG
ACATCTTCTCT -> CATCTTCTCTG
TGCGCGATTAA -> GCGCGATTAAG
ATTCCCGAATA -> TTCCCGAATAC
CGCGATTAAGA -> GCGATTAAGAA
GCTATTGCCCG -> CTATTGCCCGT
GAACGTATCGA -> AACGTATCGAT
TGGAGCGCGGG -> GGAGCGCGGGC
GCGGTTTGGAA -> CGGTTTGGAAC
CAGCTCGCGTG -> AGCTCGCGTGT
GCCCTACAATT -> CCCTACAATTG
CGCAAGCAAGC -> GCAAGCAAGCA
AGTATGCTAAC -> GTATGCTAACC
GACGAGCTGCT -> ACGAGCTGCTG
GGCAATAAGAT -> GCAATAAGATT
CGACCGGGTCG -> GACCGGGTCGA
AAATCAATAGC -> AATCAATAGCG
TGTTACGCGTT -> GTTACGCGTTT
CTATCGGTCAG -> TATCGGTCAGT
ATCAATAGCGA -> TCAATAGCGAT
GTTAAAGTGTC -> TTAAAGTGTCG
GGAGGCCTTGC -> GAGGCCTTGCA
GCGAGGTACAT -> CGAGGTACATT
CGCGGAAGCGG -> GCGGAAGCGGG
GCTACTTCGAT -> CTACTTCGATT
GTAGAGCTAGT -> TAGAGCTAGTC
CAGGAGGACCA -> AGGAGGACCAT
AAACGGTATAA -> AACGGTATAAA
GTCCTTACTAC -> TCCTTACTACC
AGGTGTCAACA -> GGTGTCAACAT
GACACTGGGTA -> ACACTGGGTAC
GCGCGGAAGCG -> CGCGGAAGCGG
GATGCGGCCGA -> ATGCGGCCGAC
GCCTTTAGATT -> CCTTTAGATTG
AGCACAGCCAG -> GCACAGCCAGG
CCACGGTGGGC -> CACGGTGGGCT
ACATCGGCGCC -> CATCGGCGCCC
AATACGTACTC -> ATACGTACTCG
TGTGTCCCAGA -> GTGTCCCAGAG
TAGATGGATAC -> AGATGGATACC
AGTATATTGAT -> GTATATTGATT
CGGGTGGCGTA -> GGGTGGCGTAT
TATCGATAGTA -> ATCGATAGTAA
TCATCTAGAAC -> CATCTAGAACC
GGGCAGGGTCC -> GGCAGGGTCCT
ACTACCTATCA -> CTACCTATCAC
TCGCAAGCAAG -> CGCAAGCAAGC
GATTAAGCCGC -> ATTAAGCCGCG
AGATGTATGAG -> GATGTATGAGG
AGATGCGGCCG -> GATGCGGCCGA
CACCATCTCTC -> ACCATCTCTCC
CACTGCCTTAG -> ACTGCCTTAGT
ACTGGTTGCCG -> CTGGTTGCCGT
CCCAGAGGCGC -> CCAGAGGCGCA
GCGCGCTAATA -> CGCGCTAATAA
AGTTTGAGGCG -> GTTTGAGGCGC
GGTCAGTGTTA -> GTCAGTGTTAC
GGTCGAAACCT -> GTCGAAACCTA
CTCTGAGGTCG -> TCTGAGGTCGA
GTGGTGTAGTC -> TGGTGTAGTCG
ATGAACAGCTC -> TGAACAGCTCG
TCTCCGACCGG -> CTCCGACCGGG
CGGTGGGCTAT -> GGTGGGCTATT
AAGGCCGCACT -> AGGCCGCACTG
GGTGTTGGCCT -> GTGTTGGCCTG
GACGTCAACTA -> ACGTCAACTAG
GCCTATCGGTC -> CCTATCGGTCA
GGATCAGCCGA -> GATCAGCCGAT
CTGTATCTCCG -> TGTATCTCCGA
CCTCTGAGGTC -> CTCTGAGGTCG
GCAGGGTCCTT -> CAGGGTCCTTA
TTTATCTAGAT -> TTATCTAGATG
CTATAAAAAAA -> TATAAAAAAAA
GAATCCTCTAT -> AATCCTCTATC
GTGTAATGTTC -> TGTAATGTTCC
CAAGCACAGCC -> AAGCACAGCCA
AAAATACGCGT -> AAATACGCGTG
GGAGTATCAAA -> GAGTATCAAAA
ACATAAGGTGT -> CATAAGGTGTC
GCGACATCCAT -> CGACATCCATC
ACGAATCGCCC -> CGAATCGCCCC
CTTCTCTGCTC -> TTCTCTGCTCT
CTCGACCATTA -> TCGACCATTAA
GGCCTCTTGCT -> GCCTCTTGCTG
CACTGCTTTTG -> ACTGCTTTTGT
ATCCAGTGTAA -> TCCAGTGTAAT
ATTTACTAATA -> TTTACTAATAG
GTTCTCGGTAG -> TTCTCGGTAGA
ATAAGATTCCC -> TAAGATTCCCG
AACATGTTACG -> ACATGTTACGC
GAGGACCATAT -> AGGACCATATG
CGTATGATCAC -> GTATGATCACT
TACGTCTGGTG -> ACGTCTGGTGT
ATAGTTAAAGT -> TAGTTAAAGTG
GGCCGCACTGC -> GCCGCACTGCT
AAGAATACGGT -> AGAATACGGTG
CAAGATAGTGT -> AAGATAGTGTT
GCCTGACGTTC -> CCTGACGTTCT
ACATGACACTG -> CATGACACTGG
CCTATCACCTG -> CTATCACCTGG
ATCTCACCAGT -> TCTCACCAGTA
AGAGCTAGTCG -> GAGCTAGTCGA
AAGTGCTACGT -> AGTGCTACGTA
CCCGTATGATC -> CCGTATGATCA
ATTGGGTAATA -> TTGGGTAATAA
CAGCCCGATTG -> AGCCCGATTGG
CGCGCGGAAGC -> GCGCGGAAGCG
TATGCCATTAC -> ATGCCATTACT
CCTCTACAAAC -> CTCTACAAACT
GACCCACCATC -> ACCCACCATCT
CCCGTCATAAT -> CCGTCATAATC
TGTGTGCTCAT -> GTGTGCTCATA
TACGGTGGTAC -> ACGGTGGTACA
CCTGGGCCGCA -> CTGGGCCGCAC
AGCAACGCCCT -> GCAACGCCCTA
AGCGTGGGTTG -> GCGTGGGTTGT
GATTGTGTAGG -> ATTGTGTAGGT
AAGCGGGGTTA -> AGCGGGGTTAG
AGGTAGATGGA -> GGTAGATGGAT
GCGTATTATTT -> CGTATTATTTC
CCGGGTCGAAA -> CGGGTCGAAAC
ATAGCAATTTA -> TAGCAATTTAT
AACCTCTACAA -> ACCTCTACAAA
GTACGTCTGGT -> TACGTCTGGTG
ATTAATTCTAA -> TTAATTCTAAG
CATTCCATCTC -> ATTCCATCTCA
TATGAGGTGTT -> ATGAGGTGTTG
ATATGCCTATC -> TATGCCTATCG
GCGCGATTAAG -> CGCGATTAAGA
CCCGGTCTAGT -> CCGGTCTAGTA
CTCCTGTGCTT -> TCCTGTGCTTA
TGGACACAAAG -> GGACACAAAGT
TAAGCTAACGC -> AAGCTAACGCA
CTTACATCGGC -> TTACATCGGCG
ACAAATAAGGT -> CAAATAAGGTT
AAAGCAAGGGA -> AAGCAAGGGAT
CGGCGGTTTGG -> GGCGGTTTGGA
GTCAACTAGAA -> TCAACTAGAAG
TTCTCGGTAGA -> TCTCGGTAGAG
TCCCACCTTCT -> CCCACCTTCTT
GTACACTACTC -> TACACTACTCC
TCCAGTGTAAT -> CCAGTGTAATG
TTCGCAAGCAA -> TCGCAAGCAAG
GCCTTGCAGGG -> CCTTGCAGGGC
CTGGGTACTCG -> TGGGTACTCGG
CGTGGGTTGTT -> GTGGGTTGTTA
TACAACGCAGG -> ACAACGCAGGC
TGATGTAGTGC -> GATGTAGTGCA
TTGAATAGCAA -> TGAATAGCAAT
CAATTGGGTAA -> AATTGGGTAAT
CCCGAATACGT -> CCGAATACGTA
ACCTCTACAAA -> CCTCTACAAAC
GAGTCTTACAT -> AGTCTTACATC
ACATTTTATGA -> CATTTTATGAT
GTTACAACATG -> TTACAACATGA
GTGAGGGTATA -> TGAGGGTATAG
CCTCCAGCCCG -> CTCCAGCCCGA
ATGTGTCCCAG -> TGTGTCCCAGA
GCCCGAGTATA -> CCCGAGTATAT
CAGTACGACCC -> AGTACGACCCC
GGCGCCCTGCA -> GCGCCCTGCAG
CAACCGCTACT -> AACCGCTACTT
GTTATAGTTTG -> TTATAGTTTGA
CACCAGTACGA -> ACCAGTACGAC
GACGTTCTCGG -> ACGTTCTCGGT
GCTGCCCGTAT -> CTGCCCGTATG
GCGTGTGCCTG -> CGTGTGCCTGA
GAATACGTACT -> AATACGTACTC
CGTATCGATAG -> GTATCGATAGT
CGCACTGCTTT -> GCACTGCTTTT
CGAATCCTCTA -> GAATCCTCTAT
TAAGCTGATAA -> AAGCTGATAAC
CCGACCGGGTC -> CGACCGGGTCG
TCTTCGGGCGG -> CTTCGGGCGGC
GCGCGAGGTAC -> CGCGAGGTACA
AGCCGCGCGGA -> GCCGCGCGGAA
TAGCAATTTAT -> AGCAATTTATC
GACGCTTACGC -> ACGCTTACGCG
CCCCAACGAAC -> CCCAACGAACC
GGAGGGGCCCT -> GAGGGGCCCTA
GGGTATAGACG -> GGTATAGACGT
TCGCCCCATTC -> CGCCCCATTCC
AATAAACCCGG -> ATAAACCCGGT
AGAAGCAACCG -> GAAGCAACCGC
AAATCGAGAAG -> AATCGAGAAGC
CTGCTCTAAAG -> TGCTCTAAAGT
TCCATCGGGTG -> CCATCGGGTGG
GTCAACATAAA -> TCAACATAAAC
TATCCTCCCAC -> ATCCTCCCACC
TTAAGCCGCGC -> TAAGCCGCGCG
CTAGAACCTCT -> TAGAACCTCTA
TTACTAATAGC -> TACTAATAGCG
CTAAGACGAAC -> TAAGACGAACG
TGGCACCGGTG -> GGCACCGGTGA
GGTTGCCGTAT -> GTTGCCGTATA
TGTTATAGTTT -> GTTATAGTTTG
TTGGAACGGGG -> TGGAACGGGGG
AGAGGCGCAGG -> GAGGCGCAGGG
CGTAGTATGCT -> GTAGTATGCTA
ATTGGAGGACC -> TTGGAGGACCC
CACCATGAACA -> ACCATGAACAG
GATGTGTCCCA -> ATGTGTCCCAG
TGGAGCGCAGT -> GGAGCGCAGTG
ACCTATGCCAT -> CCTATGCCATT
GCCGTATAGTT -> CCGTATAGTTA
AATGAAATCAA -> ATGAAATCAAT
GACACAAAGTG -> ACACAAAGTGG
CACGGTGGGCT -> ACGGTGGGCTA
CTAAGCTGATA -> TAAGCTGATAA
GCGCCCTGCAG -> CGCCCTGCAGG
AGACGTCAACT -> GACGTCAACTA
TACACTACTCC -> ACACTACTCCT
TGATAACCTTC -> GATAACCTTCC
CCATTTACTAA -> CATTTACTAAT
TAATGTTCCAA -> AATGTTCCAAA
TAGAACCTCTA -> AGAACCTCTAC
TTCGATTGGAG -> TCGATTGGAGG
AAGAAAGCAAG -> AGAAAGCAAGG
CGTTCTAAGAA -> GTTCTAAGAAT
AGTGGTGTAGT -> GTGGTGTAGTC
GGGGTAACAAA -> GGGTAACAAAT
CCGTCCCGGAA -> CGTCCCGGAAC
TTATAGTTTGA -> TATAGTTTGAG
CTTAGTCTACT -> TTAGTCTACTT
GTTAAAAGTGC -> TTAAAAGTGCT
CTCTTGCTGCC -> TCTTGCTGCCC
CAAATAAGGTT -> AAATAAGGTTG
ACTAATTGTAA -> CTAATTGTAAA
CTCTACAAACT -> TCTACAAACTC
TTGTGTACCAT -> TGTGTACCATT
CTCTACGACGG -> TCTACGACGGA
TCCGAGGGCCT -> CCGAGGGCCTC
ACAGATCGGCG -> CAGATCGGCGG
CGTGAAGAGTC -> GTGAAGAGTCA
AACATAAACAC -> ACATAAACACC
TACTGGCACCG -> ACTGGCACCGG
GAGGCGCAGGG -> AGGCGCAGGGG
CTAAGCTAACG -> TAAGCTAACGC
TTCGGGCGGCC -> TCGGGCGGCCG
ACGTTCTCGGT -> CGTTCTCGGTA
GTGCCTGACGT -> TGCCTGACGTT
CCCACCATCTC -> CCACCATCTCT
ATATGCGCGAT -> TATGCGCGATT
ACTGCCTTAGT -> CTGCCTTAGTC
CATTGGCGCAC -> ATTGGCGCACC
CCGTTATTTTG -> CGTTATTTTGT
ATGCGCGATTA -> TGCGCGATTAA
CCTTCCGTTCT -> CTTCCGTTCTA
TAACCTTCCGT -> AACCTTCCGTT
TTTTACATGCG -> TTTACATGCGC
CCTGCAAGATA -> CTGCAAGATAG
GTACTCGGGAC -> TACTCGGGACT
AAAAAAAATCG -> AAAAAAATCGA
TCAACGGGCAG -> CAACGGGCAGG
CTACTCAGACC -> TACTCAGACCA
CTGCCCGTATG -> TGCCCGTATGA
CAAGGCACCAT -> AAGGCACCATG
AGCCCGATTGG -> GCCCGATTGGG
GGTACACTACT -> GTACACTACTC
TTTATGATGTA -> TTATGATGTAG
CTGGGACAAGG -> TGGGACAAGGC
TCTAAGATTGG -> CTAAGATTGGA
CTGCTGCCGTC -> TGCTGCCGTCC
ATAGTGTTACA -> TAGTGTTACAA
CCTACAATTGG -> CTACAATTGGG
ACTGGCACCGG -> CTGGCACCGGT
CTGCTTTTGTG -> TGCTTTTGTGG
AGGGCCTCTTG -> GGGCCTCTTGC
GTGGGGTTAAA -> TGGGGTTAAAA
TAACCTGCAAG -> AACCTGCAAGA
GTTCTTGAATA -> TTCTTGAATAG
GTTGTGTGCTC -> TTGTGTGCTCA
AAGGGATCGCG -> AGGGATCGCGC
CATCTCACCAG -> ATCTCACCAGT
TCCAGCCCGAT -> CCAGCCCGATT
CGCGCGAGGTA -> GCGCGAGGTAC
GGTGGCGTATT -> GTGGCGTATTA
TCTAGAACCTC -> CTAGAACCTCT
GGTCTAAGATT -> GTCTAAGATTG
GGGTCCTTACT -> GGTCCTTACTA
TTTTATGATGT -> TTTATGATGTA
GCCTTAGTCTA -> CCTTAGTCTAC
AGCTAGTCGAC -> GCTAGTCGACG
CCTCTATCTAA -> CTCTATCTAAT
GAGCTAGTCGA -> AGCTAGTCGAC
CGGCCGACCAC -> GGCCGACCACA
GTATAAATGAA -> TATAAATGAAA
CTAGTCGACGA -> TAGTCGACGAG
CAAAAATAACA -> AAAAATAACAT
AGTCTTACATC -> GTCTTACATCG
GAGGCCTTGCA -> AGGCCTTGCAG
GCCGACCACAC -> CCGACCACACA
TACATCGGCGC -> ACATCGGCGCC
TCCTCCCACCT -> CCTCCCACCTT
AGCAAGGGATC -> GCAAGGGATCG
AAGTACGTCTG -> AGTACGTCTGG
TCACTAATTGT -> CACTAATTGTA
CATTAATTCTA -> ATTAATTCTAA
GGAGCGCGGGC -> GAGCGCGGGCG
GATAGTGTTAC -> ATAGTGTTACA
TCCCGTCATAA -> CCCGTCATAAT
ACTCGGTCTTA -> CTCGGTCTTAT
ATTGCCCGTTC -> TTGCCCGTTCC
GCACAGCCAGG -> CACAGCCAGGA
TAAAAGTGCTA -> AAAAGTGCTAC
AGCGCGCTAAT -> GCGCGCTAATA
AGTATCAAAAA -> GTATCAAAAAT
ACAAACTCGAC -> CAAACTCGACC
CTTGAATAGCA -> TTGAATAGCAA
CAGCCAGGAGG -> AGCCAGGAGGA
CACCTGGGGCA -> ACCTGGGGCAA
TATGCGCGATT -> ATGCGCGATTA
CCTTAGTCTAC -> CTTAGTCTACT
TCCACGGTGGG -> CCACGGTGGGC
AATCTATAAAA -> ATCTATAAAAA
ATTGTGTAGGT -> TTGTGTAGGTC
GTCCCGGAACA -> TCCCGGAACAG
GCCAGGAGGAC -> CCAGGAGGACC
ACGCGTGAAGA -> CGCGTGAAGAG
TCTCGGTAGAG -> CTCGGTAGAGC
GGAAGCAACGC -> GAAGCAACGCC
TGGGGTTAAAA -> GGGGTTAAAAG
GTCGAGGACTG -> TCGAGGACTGG
CGTGTGCCTGA -> GTGTGCCTGAC
CCGACCACACA -> CGACCACACAT
TATAAATGAAA -> ATAAATGAAAT
GCAAGCCACGA -> CAAGCCACGAA
TAAGGTGTCAA -> AAGGTGTCAAC
AAGCACAGCCA -> AGCACAGCCAG
CCACCATCTCT -> CACCATCTCTC
CTATCTAATCA -> TATCTAATCAG
TTAGTCGAACA -> TAGTCGAACAT
GCGGAAGCAAC -> CGGAAGCAACG
CCTATGCCATT -> CTATGCCATTA
GAGGTCGAGGA -> AGGTCGAGGAC
GTCCCAGAGGC -> TCCCAGAGGCG
AACGAACCATG -> ACGAACCATGA
CATAAACACCA -> ATAAACACCAT
AAGCCGCGCGG -> AGCCGCGCGGA
GATTCCCGAAT -> ATTCCCGAATA
ATAGACATTTT -> TAGACATTTTA
ATCTAGATGCG -> TCTAGATGCGG
TCTGGTGTTCG -> CTGGTGTTCGC
CGGTCTAGTAT -> GGTCTAGTATT
AGATTGGAGTA -> GATTGGAGTAT
GGGTTGTTATA -> GGTTGTTATAG
CCTCCACGGTG -> CTCCACGGTGG
GGCGACATCCA -> GCGACATCCAT
GCGCTTGAAGC -> CGCTTGAAGCG
GCCATTACTGG -> CCATTACTGGT
TTATTTCATCT -> TATTTCATCTA
TCGGAGGCCTT -> CGGAGGCCTTG
TTTTGTGGGGT -> TTTGTGGGGTT
CTGCCTTAGTC -> TGCCTTAGTCT
AAACCCGGTCT -> AACCCGGTCTA
GGGTTCTTGAA -> GGTTCTTGAAT
CCGAATACGTA -> CGAATACGTAC
ACGCATAATAC -> CGCATAATACT
GCTACGTAGTA -> CTACGTAGTAT
GAATAGCAATT -> AATAGCAATTT
GGTATAAATGA -> GTATAAATGAA
GATTGGAGTAT -> ATTGGAGTATC
GCGCTAATAAC -> CGCTAATAACA
CTGCAGGGTTG -> TGCAGGGTTGT
AAGCTGATAAC -> AGCTGATAACC
CGGTATAAATG -> GGTATAAATGA
GACGAACGTAT -> ACGAACGTATC
AGAACCTCTAC -> GAACCTCTACA
TTTACTAATAG -> TTACTAATAGC
GTATGAGGTGT -> TATGAGGTGTT
CCGTTCCCGTC -> CGTTCCCGTCA
CATGTTACGCG -> ATGTTACGCGT
ATAAAAAAAAT -> TAAAAAAAATC
CCATCTCTCCG -> CATCTCTCCGA
CGTCATAATCT -> GTCATAATCTA
CTCCCACCTTC -> TCCCACCTTCT
GGTCTTATGGA -> GTCTTATGGAG
CCGCTACTTCG -> CGCTACTTCGA
GTGTTACAACG -> TGTTACAACGC
CATATGCCTAT -> ATATGCCTATC
CCCTACAATTG -> CCTACAATTGG
TAAATGTGGAC -> AAATGTGGACA
TAGTATTGTTA -> AGTATTGTTAT
ACCATCTCTCC -> CCATCTCTCCG
TTACATGCGCT -> TACATGCGCTT
CTAATTGTAAA -> TAATTGTAAAC
CGCAGTGACGC -> GCAGTGACGCT
GCGTGAAGAGT -> CGTGAAGAGTC
GGTATAGACGT -> GTATAGACGTC
CCACACATAAG -> CACACATAAGG
GGAAGCGGGGT -> GAAGCGGGGTT
TAGAAGGTAGA -> AGAAGGTAGAT
GCGAATCCTCT -> CGAATCCTCTA
TGAAGCGCGCT -> GAAGCGCGCTA
GGTGGTACACT -> GTGGTACACTA
GTCTACTTCCT -> TCTACTTCCTC
TTATGATGTAG -> TATGATGTAGT
TCTAGATGCGG -> CTAGATGCGGC
ACGGTATAAAT -> CGGTATAAATG
AGTACGTCTGG -> GTACGTCTGGT
TTCCATCTCAC -> TCCATCTCACC
AGTGTTACAAC -> GTGTTACAACA,GTGTTACAACG
TTCCAAAATAC -> TCCAAAATACG
AAGGCACCATG -> AGGCACCATGA
TTTACATGCGC -> TTACATGCGCT
GGATACCCAAC -> GATACCCAACC
ACGAACGTATC -> CGAACGTATCG
CAGATTGGGTC -> AGATTGGGTCT
CGCACTAAGCT -> GCACTAAGCTA
AAGATTCCCGA -> AGATTCCCGAA
GTGGGCTATTG -> TGGGCTATTGC
CTAGATGCGGC -> TAGATGCGGCC
TGTAAACGGTA -> GTAAACGGTAT
GACCCCAACGA -> ACCCCAACGAA
ACATGTTACGC -> CATGTTACGCG
ATAAGGTTGGA -> TAAGGTTGGAG
TATCTAGATGC -> ATCTAGATGCG
CGGCGCCCTGC -> GGCGCCCTGCA
TCTCCACGCAT -> CTCCACGCATT
TTACATCGGCG -> TACATCGGCGC
TAACGCATAAT -> AACGCATAATA
GTATAGACGTC -> TATAGACGTCA
GCTTACGCGGC -> CTTACGCGGCA
TTCTCTGCTCT -> TCTCTGCTCTA
ACTAGAAGGCC -> CTAGAAGGCCG
AGAAGGCCGCA -> GAAGGCCGCAC
CCACTACCTAT -> CACTACCTATC
TAGTGCAGCAG -> AGTGCAGCAGA
AATCAATAGCG -> ATCAATAGCGA
ATTTCATCTAG -> TTTCATCTAGA
CGGTGAGGGTA -> GGTGAGGGTAT
TTGCTGCCCGT -> TGCTGCCCGTA
CTACTTCGATT -> TACTTCGATTG
TTATATGACTT -> TATATGACTTG
GTGTCAACATA -> TGTCAACATAA
CGCGTGAAGAG -> GCGTGAAGAGT
CAGCCGATGCC -> AGCCGATGCCT
GAACCATGAGT -> AACCATGAGTC
CCATTCCATCT -> CATTCCATCTC
CGACGAGCTGC -> GACGAGCTGCT
ACGGTGGGCTA -> CGGTGGGCTAT
AAACTCGACCA -> AACTCGACCAT
GAAAGCAAGGG -> AAAGCAAGGGA
ACGGAGGGGCC -> CGGAGGGGCCC
TCGGCGGTTTG -> CGGCGGTTTGG
TATTGCCCGTT -> ATTGCCCGTTC
ACCCCAACGAA -> CCCCAACGAAC
AACAGATCGGC -> ACAGATCGGCG
ACCTTCCGTTC -> CCTTCCGTTCT
GATACCCAACC -> ATACCCAACCT
GGGGCAATAAG -> GGGCAATAAGA
CGGTAGAGCTA -> GGTAGAGCTAG
GTAGTCGGAGG -> TAGTCGGAGGC
CCCGATTGGGC -> CCGATTGGGCG
GCTAACGCATA -> CTAACGCATAA
TGCCCGTATGA -> GCCCGTATGAT
GTATGATCACT -> TATGATCACTA
AGCGCGGGCGA -> GCGCGGGCGAA
CCAACCTCTGA -> CAACCTCTGAG
TGTTACAACGC -> GTTACAACGCA
CCGCACTGCTT -> CGCACTGCTTT
CGCAGGCGACA -> GCAGGCGACAT
CGCCCTACTCA -> GCCCTACTCAG
CAAGGGATCGC -> AAGGGATCGCG
TCTTATGGAGC -> CTTATGGAGCG
ACCTCTGAGGT -> CCTCTGAGGTC
TAGATGTATGA -> AGATGTATGAG
TCAATAGCGAT -> CAATAGCGATG
GCATTTACTGT -> CATTTACTGTT
CCAGTGTAATG -> CAGTGTAATGT
TCGGTCAGTGT -> CGGTCAGTGTT
CATTTTATGAT -> ATTTTATGATG
TCGGGCGGCCG -> CGGGCGGCCGT
GTCTAAGATTG -> TCTAAGATTGG
AGGACCCACCA -> GGACCCACCAT
CTATGCCATTA -> TATGCCATTAC
ATAATCTATAA -> TAATCTATAAA
ACACTACTCCT -> CACTACTCCTG
GAACCTCTACA -> AACCTCTACAA
AGCAAGCACAG -> GCAAGCACAGC
TGGCGTATTAT -> GGCGTATTATT
TAGTCGACGAG -> AGTCGACGAGC
TGGGTAATAAA -> GGGTAATAAAC
GCTGCCGTCCC -> CTGCCGTCCCG
GGAGGACCCAC -> GAGGACCCACC
ACTAAGCTAAC -> CTAAGCTAACG
CCGGTCTAGTA -> CGGTCTAGTAT
GAAGGTAGATG -> AAGGTAGATGG
GTGTTCGCAAG -> TGTTCGCAAGC
GTTGGAGCGCG -> TTGGAGCGCGG
ATACGTACTCG -> TACGTACTCGG
GACTTGGGGAT -> ACTTGGGGATC
TAAAAAAAATC -> AAAAAAAATCG
TGAGGACAATA -> GAGGACAATAT
GCTCATAGACA -> CTCATAGACAT
GTAATAAACCC -> TAATAAACCCG
AGGGTTGTGTG -> GGGTTGTGTGC
AACATCTTCTC -> ACATCTTCTCT
ATTGGGCGGAT -> TTGGGCGGATG
TGGTGTAGTCG -> GGTGTAGTCGG
GCGCAGTGACG -> CGCAGTGACGC
TTAAAGTGTCG -> TAAAGTGTCGT
TGTATCTCCGA -> GTATCTCCGAG
ACACAAAGTGG -> CACAAAGTGGT
ACTCGACCATT -> CTCGACCATTA
CTACTTCCTCC -> TACTTCCTCCA
TCATAGACATT -> CATAGACATTT
AAAGTACGTCT -> AAGTACGTCTG
ATTTTATGATG -> TTTTATGATGT
TTACGCGGCAT -> TACGCGGCATT
GTACGACCCCA -> TACGACCCCAA
TCTCCGAGGGC -> CTCCGAGGGCC
TTATTTTGTGT -> TATTTTGTGTA
CGAGTATATTG -> GAGTATATTGA
TTACAACATGA -> TACAACATGAC
TAGTGTTACAA -> AGTGTTACAAC
AAGCGCGCTAA -> AGCGCGCTAAT
GGCGCACCTCC -> GCGCACCTCCA
TAGCGTGGGTT -> AGCGTGGGTTG
GCGATGTGTCC -> CGATGTGTCCC
CATGACACTGG -> ATGACACTGGG
GACCACACATA -> ACCACACATAA
CCTCCCACCTT -> CTCCCACCTTC
TAGGTCTAAGA -> AGGTCTAAGAT
GGCGGATGCCC -> GCGGATGCCCG
GCCGTTATTTT -> CCGTTATTTTG
TTGGCCTGGGC -> TGGCCTGGGCC
AGCAATTTATC -> GCAATTTATCT
TACCATTTACT -> ACCATTTACTA
TAAGCCGCGCG -> AAGCCGCGCGG
AAGACGAACGT -> AGACGAACGTA
GTTAGATGTAT -> TTAGATGTATG
CAGACCAACTC -> AGACCAACTCT
TCGGGTGGCGT -> CGGGTGGCGTA
GACCGGGTCGA -> ACCGGGTCGAA
AGTCGAACATG -> GTCGAACATGT
CTGAGGTCGAG -> TGAGGTCGAGG
AGGTCGAGGAC -> GGTCGAGGACT
GCCATTGGCGC -> CCATTGGCGCA
GCTAGTCGACG -> CTAGTCGACGA
ACAACATGACA -> CAACATGACAC
GGGGCCCTACA -> GGGCCCTACAA
GCACTGCTTTT -> CACTGCTTTTG
CTACCTATCAC -> TACCTATCACC
TAATCAGATCC -> AATCAGATCCA
CTAATAGCGTG -> TAATAGCGTGG
TCCCGGAACAG -> CCCGGAACAGA
GCATAATACTG -> CATAATACTGG
AAAAAATCGAG -> AAAAATCGAGA
GGTCGAGGACT -> GTCGAGGACTG
TGTGTAGGTCT -> GTGTAGGTCTA
CCGAGTATATT -> CGAGTATATTG
TAGTATGCTAA -> AGTATGCTAAC
TCTAATCAGAT -> CTAATCAGATC
GACCATTAATT -> ACCATTAATTC
CAGAGGCGCAG -> AGAGGCGCAGG
CATTTACTAAT -> ATTTACTAATA
GATGTATGAGG -> ATGTATGAGGT
CTTATGGAGCG -> TTATGGAGCGC
CCTGCAGGGTT -> CTGCAGGGTTG
ACATCACTGTA -> CATCACTGTAT
CTCGCGTGTGC -> TCGCGTGTGCC
CCCATTCCATC -> CCATTCCATCT
GAAGGCCGCAC -> AAGGCCGCACT
GGGTGGCGTAT -> GGTGGCGTATT
CCGATTGGGCG -> CGATTGGGCGG
TAAGGTTGGAG -> AAGGTTGGAGC
CTTGGGGATCA -> TTGGGGATCAG
AACCTATGCCA -> ACCTATGCCAT
AAAAGTGCTAC -> AAAGTGCTACG
GGGCCGCACTA -> GGCCGCACTAA
CGTCAACGGGC -> GTCAACGGGCA
GTGGGTTGTTA -> TGGGTTGTTAT
ACAGCCAGGAG -> CAGCCAGGAGG
AAACACCATTT -> AACACCATTTT
CTGGTTGCCGT -> TGGTTGCCGTA
ATATTGATTAA -> TATTGATTAAG
AGCCACGAATC -> GCCACGAATCG
GCCTCTTGCTG -> CCTCTTGCTGC
CCTTTAGATTG -> CTTTAGATTGT
ATAGCGATGTG -> TAGCGATGTGT
GACAATATGCG -> ACAATATGCGC
GAGGACAATAT -> AGGACAATATG
TAAACCCGGTC -> AAACCCGGTCT
GTGTCCCAGAG -> TGTCCCAGAGG
AACGTATCGAT -> ACGTATCGATA
TATGCCTATCG -> ATGCCTATCGG
AGTACGACCCC -> GTACGACCCCA
TAGTAAATGTG -> AGTAAATGTGG
TCAGTGTTACA -> CAGTGTTACAA
GGAACGGGGGT -> GAACGGGGGTA
ACGGACGGAGG -> CGGACGGAGGG
GGTTGTGTGCT -> GTTGTGTGCTC
TCTACTTCCTC -> CTACTTCCTCC
GCTCTAAAGTA -> CTCTAAAGTAC
TACATTGTCAC -> ACATTGTCACT
TATGATGTAGT -> ATGATGTAGTG
TTCTTCGGGCG -> TCTTCGGGCGG
ATGCCCGAGTA -> TGCCCGAGTAT
CAGATCCAGTG -> AGATCCAGTGT
TCGAGAAGCAA -> CGAGAAGCAAC
AGGCCGCACTG -> GGCCGCACTGC
TACTCCTGTGC -> ACTCCTGTGCT
TAGCGATGTGT -> AGCGATGTGTC
TGAGGTCGAGG -> GAGGTCGAGGA
CGTTCCCGTCA -> GTTCCCGTCAT
GGAGGACCATA -> GAGGACCATAT
GAGGACTGGGA -> AGGACTGGGAC
TCTAAAGTACG -> CTAAAGTACGT
TAACATCACTG -> AACATCACTGT
ACGCGGCATTT -> CGCGGCATTTA
TCTTGAATAGC -> CTTGAATAGCA
CTCTAAAGTAC -> TCTAAAGTACG
ATCCATCGGGT -> TCCATCGGGTG
GACGGAGGGGC -> ACGGAGGGGCC
CGGGGGTAACA -> GGGGGTAACAA
GAGTATCAAAA -> AGTATCAAAAA
AATTCTAAGAC -> ATTCTAAGACG
GCGGGGTTAGT -> CGGGGTTAGTC
CGGGCAGGGTC -> GGGCAGGGTCC
TAAGAATACGG -> AAGAATACGGT
GCAAGCACAGC -> CAAGCACAGCC
GCTGATAACCT -> CTGATAACCTT
CCCTACTCAGA -> CCTACTCAGAC
AAAGTGTCGTC -> AAGTGTCGTCA
ACCATATGCCT -> CCATATGCCTA
