CTAGCCCTTCGGATCATGGTCGGC -> TAGCCCTTCGGATCATGGTCGGCC
GCCCTTCGGATCATGGTCGGCCGC -> CCCTTCGGATCATGGTCGGCCGCC
CCAGGGGCGCACGCTCTATGGAAA -> CAGGGGCGCACGCTCTATGGAAAC
CAGGCTTAGACGCGCAACGAAAGA -> AGGCTTAGACGCGCAACGAAAGAT
GGCAGTAGTAGTGTGTTCTGAGGG -> GCAGTAGTAGTGTGTTCTGAGGGT
CGAGCGTAGAAGTAGCTTGGATCG -> GAGCGTAGAAGTAGCTTGGATCGC
CAGATCCGATTTTGGGCGGTGGTG -> AGATCCGATTTTGGGCGGTGGTGA
GAGCGTTGTAGGTCATTAATAAGG -> AGCGTTGTAGGTCATTAATAAGGT
GTTTGCACTATTTTATCGCTTCGG -> TTTGCACTATTTTATCGCTTCGGG
TACCAACTGTTTACCGGGCCAGCG -> ACCAACTGTTTACCGGGCCAGCGC
TGGGGTAGTTCTTCTATATCCCGG -> GGGGTAGTTCTTCTATATCCCGGA
GGAAAGGTTGCGTAGTCTACTGCA -> GAAAGGTTGCGTAGTCTACTGCAA
CCTAACCATGGCCATATAAATATT -> CTAACCATGGCCATATAAATATTT
TTTCATTAAACAAACACCTTTTAC -> TTCATTAAACAAACACCTTTTACT
CGGCCATTCTATTGCAACTGGCAC -> GGCCATTCTATTGCAACTGGCACG
GCATAACCATTGTTCTTATATCGA -> CATAACCATTGTTCTTATATCGAT
GCGTTGTAGGTCATTAATAAGGTG -> CGTTGTAGGTCATTAATAAGGTGA
ATTTTGGGCGGTGGTGAACTATGA -> TTTTGGGCGGTGGTGAACTATGAC
CCGCCATCCAATCGCTCGCCTGAC -> CGCCATCCAATCGCTCGCCTGACG
GGGCGTACATCTTGACCGGTTACT -> GGCGTACATCTTGACCGGTTACTA
TGTGTTCTGAGGGTGAGAGACCTG -> GTGTTCTGAGGGTGAGAGACCTGG
CTATGACCTAATAGTATAAGGAAC -> TATGACCTAATAGTATAAGGAACT
AGCGTTGTAGGTCATTAATAAGGT -> GCGTTGTAGGTCATTAATAAGGTG
TATTTTCCCTGTTAGACCTAGCAA -> ATTTTCCCTGTTAGACCTAGCAAG
TAAGAATCACCCAAGCATGCAGCG -> AAGAATCACCCAAGCATGCAGCGA
TTGAATAGATACAAATCGGTGGAC -> TGAATAGATACAAATCGGTGGACC
CTGCTCGAATGCGTCTTGAATAGA -> TGCTCGAATGCGTCTTGAATAGAT
TATCGATCCGGATAGCACAGAACA -> ATCGATCCGGATAGCACAGAACAT
ACGCTCTATGGAAACCCTGAATCC -> CGCTCTATGGAAACCCTGAATCCG
AACCATGGCCATATAAATATTTTC -> ACCATGGCCATATAAATATTTTCC
AGCATTTTTACCTCGCAATCTAAC -> GCATTTTTACCTCGCAATCTAACG
CATGATTGTGTGCTGTATACAGTC -> ATGATTGTGTGCTGTATACAGTCA
GTGAGAGACCTGGGACCGCCTATA -> TGAGAGACCTGGGACCGCCTATAC
GCTCTATGGAAACCCTGAATCCGA -> CTCTATGGAAACCCTGAATCCGAC
AGGGGCCGGCATAACCATTGTTCT -> GGGGCCGGCATAACCATTGTTCTT
TGCACCCCTATCACGATCGTATTT -> GCACCCCTATCACGATCGTATTTG
AGGCGGGTGACATTACTGCCGTGA -> GGCGGGTGACATTACTGCCGTGAG
TCCATGACACCTGTAGCCCGTGGG -> CCATGACACCTGTAGCCCGTGGGC
AAAATTCGGTGTGCTACACCAGAA -> AAATTCGGTGTGCTACACCAGAAA
CTCGGCATACTAGCACTTACACCA -> TCGGCATACTAGCACTTACACCAG
AGCTTGGATCGCGTAAGGGCACAT -> GCTTGGATCGCGTAAGGGCACATG
GGTTTGCACTATTTTATCGCTTCG -> GTTTGCACTATTTTATCGCTTCGG
TGCACTATTTTATCGCTTCGGGAG -> GCACTATTTTATCGCTTCGGGAGG
GCGGTGGTGAACTATGACCTAATA -> CGGTGGTGAACTATGACCTAATAG
CTTCTCGCAATATCTTGGACCCTG -> TTCTCGCAATATCTTGGACCCTGA
AAGGGCACATGCGAGGAGATATTT -> AGGGCACATGCGAGGAGATATTTA
CATAACCATTGTTCTTATATCGAT -> ATAACCATTGTTCTTATATCGATC
AAACGTGATATATCCGTTTCTTTA -> AACGTGATATATCCGTTTCTTTAC
AGTATAAGGAACTACACGCTGCTC -> GTATAAGGAACTACACGCTGCTCG
GGCCAGGAAAATTCGGTGTGCTAC -> GCCAGGAAAATTCGGTGTGCTACA
CAACGGCATAAAGACGTCCTAACC -> AACGGCATAAAGACGTCCTAACCA
TCAGGGGCCGGCATAACCATTGTT -> CAGGGGCCGGCATAACCATTGTTC
GATCCAGTCACGTACCGTGATCCA -> ATCCAGTCACGTACCGTGATCCAT
GAAAGACCCAGGGCAGTTCCGAGC -> AAAGACCCAGGGCAGTTCCGAGCC
AACGGCATAAAGACGTCCTAACCA -> ACGGCATAAAGACGTCCTAACCAT
CCGACGGAGGGCGTACATCTTGAC -> CGACGGAGGGCGTACATCTTGACC
TTAATGGGCGTTCTATGGAAAGGT -> TAATGGGCGTTCTATGGAAAGGTT
AAGCATGCAGCGATCCGTGCACCC -> AGCATGCAGCGATCCGTGCACCCC
GATACTTCGCGCCAGGCTGTATTT -> ATACTTCGCGCCAGGCTGTATTTA
TTCTGAGGGTGAGAGACCTGGGAC -> TCTGAGGGTGAGAGACCTGGGACC
ACATGGGGTAGTTCTTCTATATCC -> CATGGGGTAGTTCTTCTATATCCC
GCTTATAGCTCACAGATTAATGGG -> CTTATAGCTCACAGATTAATGGGC
GTGACATTACTGCCGTGAGTCAAT -> TGACATTACTGCCGTGAGTCAATG
CCCGGAGACCATCGCGCAAAATCC -> CCGGAGACCATCGCGCAAAATCCC
AATCCGACGGAGGGCGTACATCTT -> ATCCGACGGAGGGCGTACATCTTG
TACTTCGCGCCAGGCTGTATTTAC -> ACTTCGCGCCAGGCTGTATTTACA
AGGGTGATGGTGTACATCCGGGTC -> GGGTGATGGTGTACATCCGGGTCC
GACCCAGGGCAGTTCCGAGCCTAC -> ACCCAGGGCAGTTCCGAGCCTACG
CGCTGCTCGAATGCGTCTTGAATA -> GCTGCTCGAATGCGTCTTGAATAG
AGGTCTTTCGACGTATAGTAGGGG -> GGTCTTTCGACGTATAGTAGGGGT
AAGGTTGCGTAGTCTACTGCAAGG -> AGGTTGCGTAGTCTACTGCAAGGG
TCCGGATAGCACAGAACATACAGA -> CCGGATAGCACAGAACATACAGAA
ATCGGTGGACCAATTCTAGAATGC -> TCGGTGGACCAATTCTAGAATGCG
GTACCGTGATCCATGACACCTGTA -> TACCGTGATCCATGACACCTGTAG
TCTCCACTAGGTTTTCATTAAACA -> CTCCACTAGGTTTTCATTAAACAA
AAATCGGTGGACCAATTCTAGAAT -> AATCGGTGGACCAATTCTAGAATG
CCTACGCATCTTACTATTCCTGAC -> CTACGCATCTTACTATTCCTGACG
GCGCAAGTTAGCCTACGCATCTTA -> CGCAAGTTAGCCTACGCATCTTAC
GCGACCGCAAGCGTTGCCACACAG -> CGACCGCAAGCGTTGCCACACAGT
TCTCTCGGCATACTAGCACTTACA -> CTCTCGGCATACTAGCACTTACAC
CTATCACGATCGTATTTGGTTTGC -> TATCACGATCGTATTTGGTTTGCA
TAGGTTTTCATTAAACAAACACCT -> AGGTTTTCATTAAACAAACACCTT
GGCTTAGACGCGCAACGAAAGATC -> GCTTAGACGCGCAACGAAAGATCC
CTGAGACTGGCAACGGCATAAAGA -> TGAGACTGGCAACGGCATAAAGAC
TGGGCGTTCTATGGAAAGGTTGCG -> GGGCGTTCTATGGAAAGGTTGCGT
CGTTCCCACCACGTCTTTCAAGTA -> GTTCCCACCACGTCTTTCAAGTAC
TGAACTATGACCTAATAGTATAAG -> GAACTATGACCTAATAGTATAAGG
TCACGATGTAGGCCAGGAAAATTC -> CACGATGTAGGCCAGGAAAATTCG
TTACCTCGCAATCTAACGGTCACT -> TACCTCGCAATCTAACGGTCACTT
TGATATATCCGTTTCTTTACTTCC -> GATATATCCGTTTCTTTACTTCCG
TACGCCAGGTCTTTCGACGTATAG -> ACGCCAGGTCTTTCGACGTATAGT
GCCTCCTCATCAGGCGTTATCCCA -> CCTCCTCATCAGGCGTTATCCCAT
GAATAGATACAAATCGGTGGACCA -> AATAGATACAAATCGGTGGACCAA
GTGCTACACCAGAAAGACTAGGCG -> TGCTACACCAGAAAGACTAGGCGG
GTGGCTTAGTACGCGAGCATTTTT -> TGGCTTAGTACGCGAGCATTTTTA
TTGTTCTTATATCGATCCGGATAG -> TGTTCTTATATCGATCCGGATAGC
ATGGGCGTTCTATGGAAAGGTTGC -> TGGGCGTTCTATGGAAAGGTTGCG
CGGCATAAAGACGTCCTAACCATG -> GGCATAAAGACGTCCTAACCATGG
AGACCTAGCAAGGAGCACACGATA -> GACCTAGCAAGGAGCACACGATAT
CACGTACCGTGATCCATGACACCT -> ACGTACCGTGATCCATGACACCTG
TTACCGAAAACTCGAATCATCCGG -> TACCGAAAACTCGAATCATCCGGT
GAACGTACGCATCTGCTGTTTCCG -> AACGTACGCATCTGCTGTTTCCGC
CGCAAAATCCCGTTCAATTATGTA -> GCAAAATCCCGTTCAATTATGTAA
TCATTGATGGTGTGGCTTAGTACG -> CATTGATGGTGTGGCTTAGTACGC
GTTCTATGGAAAGGTTGCGTAGTC -> TTCTATGGAAAGGTTGCGTAGTCT
GATCGTATTTGGTTTGCACTATTT -> ATCGTATTTGGTTTGCACTATTTT
GTCACGTACCGTGATCCATGACAC -> TCACGTACCGTGATCCATGACACC
CATCATGATTGTGTGCTGTATACA -> ATCATGATTGTGTGCTGTATACAG
ATCCGTTTCTTTACTTCCGGACAC -> TCCGTTTCTTTACTTCCGGACACG
GTTCTGAGACTGGCAACGGCATAA -> TTCTGAGACTGGCAACGGCATAAA
ATGCGTCTTGAATAGATACAAATC -> TGCGTCTTGAATAGATACAAATCG
GACTCCTACAGATCCGATTTTGGG -> ACTCCTACAGATCCGATTTTGGGC
CGGTCACTTCACGGCCAGCCTTTA -> GGTCACTTCACGGCCAGCCTTTAC
CGCGTAAGGGCACATGCGAGGAGA -> GCGTAAGGGCACATGCGAGGAGAT
AGGCTGTATTTACAGAAAGACCCA -> GGCTGTATTTACAGAAAGACCCAG
TCGGATCATGGTCGGCCGCCATCC -> CGGATCATGGTCGGCCGCCATCCA
TACCGGGCCAGCGCGGCCATTCTA -> ACCGGGCCAGCGCGGCCATTCTAT
TAAGGGCACATGCGAGGAGATATT -> AAGGGCACATGCGAGGAGATATTT
GGTGTGGCTTAGTACGCGAGCATT -> GTGTGGCTTAGTACGCGAGCATTT
GGTTTTCATTAAACAAACACCTTT -> GTTTTCATTAAACAAACACCTTTT
GCACTATTTTATCGCTTCGGGAGG -> CACTATTTTATCGCTTCGGGAGGT
TCGAATGCGTCTTGAATAGATACA -> CGAATGCGTCTTGAATAGATACAA
GTCAGCTTATAGGGTTACGCTCTG -> TCAGCTTATAGGGTTACGCTCTGC
TGACATGGGGTAGTTCTTCTATAT -> GACATGGGGTAGTTCTTCTATATC
TACTATTCCTGACGGACTCCTACA -> ACTATTCCTGACGGACTCCTACAG
AGAAGTAGCTTGGATCGCGTAAGG -> GAAGTAGCTTGGATCGCGTAAGGG
GCATGCAGCGATCCGTGCACCCCT -> CATGCAGCGATCCGTGCACCCCTA
CGTATTTGGTTTGCACTATTTTAT -> GTATTTGGTTTGCACTATTTTATC
GCAGTTCCGAGCCTACGCCAGGTC -> CAGTTCCGAGCCTACGCCAGGTCT
ATATATCCGTTTCTTTACTTCCGG -> TATATCCGTTTCTTTACTTCCGGA
CACCAGAAAGACTAGGCGGGTGAC -> ACCAGAAAGACTAGGCGGGTGACA
AATCGGTGGACCAATTCTAGAATG -> ATCGGTGGACCAATTCTAGAATGC
TGCCGTGAGTCAATGCCTCATTGA -> GCCGTGAGTCAATGCCTCATTGAT
TTCATTAAACAAACACCTTTTACT -> TCATTAAACAAACACCTTTTACTC
CGCAAGTTAGCCTACGCATCTTAC -> GCAAGTTAGCCTACGCATCTTACT
CGGCATACTAGCACTTACACCAGG -> GGCATACTAGCACTTACACCAGGG
GGACACGCGCTCTCTCGGCATACT -> GACACGCGCTCTCTCGGCATACTA
TGTGAGACTCGTAAAAATCGGAAC -> GTGAGACTCGTAAAAATCGGAACG
GCCATTCTATTGCAACTGGCACGC -> CCATTCTATTGCAACTGGCACGCC
TCATGGTCGGCCGCCATCCAATCG -> CATGGTCGGCCGCCATCCAATCGC
TACCTCGCAATCTAACGGTCACTT -> ACCTCGCAATCTAACGGTCACTTC
AAATCCCGTTCAATTATGTAAAGA -> AATCCCGTTCAATTATGTAAAGAT
ACTATCGTACGTGCCTCGGCCCAA -> CTATCGTACGTGCCTCGGCCCAAA
GTCGGCCGCCATCCAATCGCTCGC -> TCGGCCGCCATCCAATCGCTCGCC
TACAAATCGGTGGACCAATTCTAG -> ACAAATCGGTGGACCAATTCTAGA
ATTAATGGGCGTTCTATGGAAAGG -> TTAATGGGCGTTCTATGGAAAGGT
GTGATATATCCGTTTCTTTACTTC -> TGATATATCCGTTTCTTTACTTCC
TGTTAGACCTAGCAAGGAGCACAC -> GTTAGACCTAGCAAGGAGCACACG
GTTTAATGGCTCGCGCTATACAAC -> TTTAATGGCTCGCGCTATACAACA
TACTTCGAAATCCGTCGCGAATCA -> ACTTCGAAATCCGTCGCGAATCAG
ATACAGAACTGGCCGCGATACTTC -> TACAGAACTGGCCGCGATACTTCG
ATGACCTAATAGTATAAGGAACTA -> TGACCTAATAGTATAAGGAACTAC
AGAGAGGGTGATGGTGTACATCCG -> GAGAGGGTGATGGTGTACATCCGG
AGATATTTATGCTACGCCCTGGTC -> GATATTTATGCTACGCCCTGGTCC
ACGCGCTCTCTCGGCATACTAGCA -> CGCGCTCTCTCGGCATACTAGCAC
CATTGATGGTGTGGCTTAGTACGC -> ATTGATGGTGTGGCTTAGTACGCG
CCTAATAGTATAAGGAACTACACG -> CTAATAGTATAAGGAACTACACGC
GTGACTCTTAAAAAGCAAGGTAGA -> TGACTCTTAAAAAGCAAGGTAGAG
TATACTCTGCGTGCGCAAGTTAGC -> ATACTCTGCGTGCGCAAGTTAGCC
CTGTATACAGTCAATTCAGCTGCT -> TGTATACAGTCAATTCAGCTGCTC
CCACGTCTTTCAAGTACCAACTGT -> CACGTCTTTCAAGTACCAACTGTT
GGCGTACATCTTGACCGGTTACTA -> GCGTACATCTTGACCGGTTACTAA
GCCACACAGTATTGACATGGGGTA -> CCACACAGTATTGACATGGGGTAG
GGCCGCCATCCAATCGCTCGCCTG -> GCCGCCATCCAATCGCTCGCCTGA
GGATCGCGTAAGGGCACATGCGAG -> GATCGCGTAAGGGCACATGCGAGG
GTGGTGAACTATGACCTAATAGTA -> TGGTGAACTATGACCTAATAGTAT
TACAGATCCGATTTTGGGCGGTGG -> ACAGATCCGATTTTGGGCGGTGGT
GTACTCGCTAGCCCTTCGGATCAT -> TACTCGCTAGCCCTTCGGATCATG
CGCGAATCAGGGGCCGGCATAACC -> GCGAATCAGGGGCCGGCATAACCA
TCACAGATTAATGGGCGTTCTATG -> CACAGATTAATGGGCGTTCTATGG
TCACGTACCGTGATCCATGACACC -> CACGTACCGTGATCCATGACACCT
GTGCACCCCTATCACGATCGTATT -> TGCACCCCTATCACGATCGTATTT
AGGAGCACACGATATAGCTTATAG -> GGAGCACACGATATAGCTTATAGC
AGGTGACTCTTAAAAAGCAAGGTA -> GGTGACTCTTAAAAAGCAAGGTAG
TGGTGTGGCTTAGTACGCGAGCAT -> GGTGTGGCTTAGTACGCGAGCATT
TTAAAAAGCAAGGTAGAGAGGGTG -> TAAAAAGCAAGGTAGAGAGGGTGA
TTTACTGGCACAAAAAACTATCGT -> TTACTGGCACAAAAAACTATCGTA
ATATCGATCCGGATAGCACAGAAC -> TATCGATCCGGATAGCACAGAACA
CGGGCCAGCGCGGCCATTCTATTG -> GGGCCAGCGCGGCCATTCTATTGC
GTACATCTTGACCGGTTACTAAGA -> TACATCTTGACCGGTTACTAAGAA
TATGGAAAGGTTGCGTAGTCTACT -> ATGGAAAGGTTGCGTAGTCTACTG
ATGGAAACCCTGAATCCGACGGAG -> TGGAAACCCTGAATCCGACGGAGG
AAGACTAGGCGGGTGACATTACTG -> AGACTAGGCGGGTGACATTACTGC
TTACGCTCTGCGTTCCCACCACGT -> TACGCTCTGCGTTCCCACCACGTC
GGACTCCTACAGATCCGATTTTGG -> GACTCCTACAGATCCGATTTTGGG
ACCTGTAGCCCGTGGGCCATCTCT -> CCTGTAGCCCGTGGGCCATCTCTT
ACTTCGCGCCAGGCTGTATTTACA -> CTTCGCGCCAGGCTGTATTTACAG
CCATGGCCATATAAATATTTTCCC -> CATGGCCATATAAATATTTTCCCT
AAACTATCGTACGTGCCTCGGCCC -> AACTATCGTACGTGCCTCGGCCCA
TGCCACACAGTATTGACATGGGGT -> GCCACACAGTATTGACATGGGGTA
GAATCATCCGGTTTAATGGCTCGC -> AATCATCCGGTTTAATGGCTCGCG
TGGCCATATAAATATTTTCCCTGT -> GGCCATATAAATATTTTCCCTGTT
AAGACGTCCTAACCATGGCCATAT -> AGACGTCCTAACCATGGCCATATA
CACGATATAGCTTATAGCTCACAG -> ACGATATAGCTTATAGCTCACAGA
AGCTGCTCCGAAGGAACACTAGCG -> GCTGCTCCGAAGGAACACTAGCGG
TTCGCGCCAGGCTGTATTTACAGA -> TCGCGCCAGGCTGTATTTACAGAA
CGCGCAACGAAAGATCCAGTCACG -> GCGCAACGAAAGATCCAGTCACGT
TGGCACGCCGTACGATGTCAACTG -> GGCACGCCGTACGATGTCAACTGC
GTGCTGTATACAGTCAATTCAGCT -> TGCTGTATACAGTCAATTCAGCTG
ACCCAGGGCAGTTCCGAGCCTACG -> CCCAGGGCAGTTCCGAGCCTACGC
GGAACTACACGCTGCTCGAATGCG -> GAACTACACGCTGCTCGAATGCGT
GCCGCCATCCAATCGCTCGCCTGA -> CCGCCATCCAATCGCTCGCCTGAC
CTTTACTTCCGGACACGCGCTCTC -> TTTACTTCCGGACACGCGCTCTCT
CGCGAGCATTTTTACCTCGCAATC -> GCGAGCATTTTTACCTCGCAATCT
ACATACAGAACTGGCCGCGATACT -> CATACAGAACTGGCCGCGATACTT
TATAAGGAACTACACGCTGCTCGA -> ATAAGGAACTACACGCTGCTCGAA
ACGTACCGTGATCCATGACACCTG -> CGTACCGTGATCCATGACACCTGT
CAACTGCGTTTTCGTGCAACGGGT -> AACTGCGTTTTCGTGCAACGGGTA
GTGTGAGACTCGTAAAAATCGGAA -> TGTGAGACTCGTAAAAATCGGAAC
CCATCTCTTCTCGCAATATCTTGG -> CATCTCTTCTCGCAATATCTTGGA
GCGCACGCTCTATGGAAACCCTGA -> CGCACGCTCTATGGAAACCCTGAA
ATGTAGGCCAGGAAAATTCGGTGT -> TGTAGGCCAGGAAAATTCGGTGTG
CTGACGGTTCGGCAGTAGTAGTGT -> TGACGGTTCGGCAGTAGTAGTGTG
TTTACCTCGCAATCTAACGGTCAC -> TTACCTCGCAATCTAACGGTCACT
GTCCTGTGAACGCCTAATGTCACG -> TCCTGTGAACGCCTAATGTCACGA
TTCGACGTATAGTAGGGGTACTCG -> TCGACGTATAGTAGGGGTACTCGC
CAACTGTTTACCGGGCCAGCGCGG -> AACTGTTTACCGGGCCAGCGCGGC
TATTTACAGAAAGACCCAGGGCAG -> ATTTACAGAAAGACCCAGGGCAGT
AATGGGCGTTCTATGGAAAGGTTG -> ATGGGCGTTCTATGGAAAGGTTGC
GCGCTATACAACAGAAAATACCGC -> CGCTATACAACAGAAAATACCGCC
GGCGGGTGACATTACTGCCGTGAG -> GCGGGTGACATTACTGCCGTGAGT
CACACGATATAGCTTATAGCTCAC -> ACACGATATAGCTTATAGCTCACA
TTTCGTGCAACGGGTATCTCGAGC -> TTCGTGCAACGGGTATCTCGAGCG
GTAGGGGTACTCGCTAGCCCTTCG -> TAGGGGTACTCGCTAGCCCTTCGG
GGAGATATTTATGCTACGCCCTGG -> GAGATATTTATGCTACGCCCTGGT
TCAGCTGCTCCGAAGGAACACTAG -> CAGCTGCTCCGAAGGAACACTAGC
AGATCCGATTTTGGGCGGTGGTGA -> GATCCGATTTTGGGCGGTGGTGAA
CTCGCAATCTAACGGTCACTTCAC -> TCGCAATCTAACGGTCACTTCACG
GCATTTTTACCTCGCAATCTAACG -> CATTTTTACCTCGCAATCTAACGG
CTAGGTTTTCATTAAACAAACACC -> TAGGTTTTCATTAAACAAACACCT
GTAGGCCAGGAAAATTCGGTGTGC -> TAGGCCAGGAAAATTCGGTGTGCT
CTGCTGTTTCCGCTGTGTGAGACT -> TGCTGTTTCCGCTGTGTGAGACTC
GCGAGCATTTTTACCTCGCAATCT -> CGAGCATTTTTACCTCGCAATCTA
CGCGTCAAGAGCGTTGTAGGTCAT -> GCGTCAAGAGCGTTGTAGGTCATT
GCTTATAGGGTTACGCTCTGCGTT -> CTTATAGGGTTACGCTCTGCGTTC
CTTGGATCGCGTAAGGGCACATGC -> TTGGATCGCGTAAGGGCACATGCG
AACTACACGCTGCTCGAATGCGTC -> ACTACACGCTGCTCGAATGCGTCT
CCTGAACGAACGTACGCATCTGCT -> CTGAACGAACGTACGCATCTGCTG
GGACCAATTCTAGAATGCGTCATC -> GACCAATTCTAGAATGCGTCATCA
TCATCAGGCGTTATCCCATAGCCC -> CATCAGGCGTTATCCCATAGCCCT
ACACCAGGGGCGCACGCTCTATGG -> CACCAGGGGCGCACGCTCTATGGA
CTTATAGCTCACAGATTAATGGGC -> TTATAGCTCACAGATTAATGGGCG
ACCGTGATCCATGACACCTGTAGC -> CCGTGATCCATGACACCTGTAGCC
TACTGCCGTGAGTCAATGCCTCAT -> ACTGCCGTGAGTCAATGCCTCATT
ATGTCACGATGTAGGCCAGGAAAA -> TGTCACGATGTAGGCCAGGAAAAT
ACGAGAAGGCTAGCTGCAATCGCG -> CGAGAAGGCTAGCTGCAATCGCGC
CATTCTATTGCAACTGGCACGCCG -> ATTCTATTGCAACTGGCACGCCGT
ACTTCGAAATCCGTCGCGAATCAG -> CTTCGAAATCCGTCGCGAATCAGG
GCGTAGAAGTAGCTTGGATCGCGT -> CGTAGAAGTAGCTTGGATCGCGTA
ACACTAGCGGTTCACCTGAACGAA -> CACTAGCGGTTCACCTGAACGAAC
TTACTCGGAGCGCCGAGCCTCCTC -> TACTCGGAGCGCCGAGCCTCCTCA
GAACACTAGCGGTTCACCTGAACG -> AACACTAGCGGTTCACCTGAACGA
AGCTTATAGGGTTACGCTCTGCGT -> GCTTATAGGGTTACGCTCTGCGTT
GAACACGGCTACTTCGAAATCCGT -> AACACGGCTACTTCGAAATCCGTC
CGGTTCGGCAGTAGTAGTGTGTTC -> GGTTCGGCAGTAGTAGTGTGTTCT
TACATCCGGGTCCTGTGAACGCCT -> ACATCCGGGTCCTGTGAACGCCTA
CAATTATGTAAAGATCGACGGCTG -> AATTATGTAAAGATCGACGGCTGG
CCGGGTCCTGTGAACGCCTAATGT -> CGGGTCCTGTGAACGCCTAATGTC
ACGGCCAGCCTTTACTGGCACAAA -> CGGCCAGCCTTTACTGGCACAAAA
ATTATGTAAAGATCGACGGCTGGG -> TTATGTAAAGATCGACGGCTGGGT
TGGATCGCGTAAGGGCACATGCGA -> GGATCGCGTAAGGGCACATGCGAG
GCACATGCGAGGAGATATTTATGC -> CACATGCGAGGAGATATTTATGCT
TTGCACTATTTTATCGCTTCGGGA -> TGCACTATTTTATCGCTTCGGGAG
AGGGCGTACATCTTGACCGGTTAC -> GGGCGTACATCTTGACCGGTTACT
AGGCAGGCTTAGACGCGCAACGAA -> GGCAGGCTTAGACGCGCAACGAAA
CCATCGCGCAAAATCCCGTTCAAT -> CATCGCGCAAAATCCCGTTCAATT
TCATTAAACAAACACCTTTTACTC -> CATTAAACAAACACCTTTTACTCG
CGGCCCAAACGTGATATATCCGTT -> GGCCCAAACGTGATATATCCGTTT
TCATCCGGTTTAATGGCTCGCGCT -> CATCCGGTTTAATGGCTCGCGCTA
CCGAGCCTCCTCATCAGGCGTTAT -> CGAGCCTCCTCATCAGGCGTTATC
CACCTGTAGCCCGTGGGCCATCTC -> ACCTGTAGCCCGTGGGCCATCTCT
CACGCTGCTCGAATGCGTCTTGAA -> ACGCTGCTCGAATGCGTCTTGAAT
GTGTACATCCGGGTCCTGTGAACG -> TGTACATCCGGGTCCTGTGAACGC
GAACTGGCCGCGATACTTCGCGCC -> AACTGGCCGCGATACTTCGCGCCA
GCTTGGATCGCGTAAGGGCACATG -> CTTGGATCGCGTAAGGGCACATGC
CCACCACGTCTTTCAAGTACCAAC -> CACCACGTCTTTCAAGTACCAACT
GCAGGCTTAGACGCGCAACGAAAG -> CAGGCTTAGACGCGCAACGAAAGA
CGGATCATGGTCGGCCGCCATCCA -> GGATCATGGTCGGCCGCCATCCAA
CGAACACGGCTACTTCGAAATCCG -> GAACACGGCTACTTCGAAATCCGT
CTGTAGCCCGTGGGCCATCTCTTC -> TGTAGCCCGTGGGCCATCTCTTCT
CTCTTCTCGCAATATCTTGGACCC -> TCTTCTCGCAATATCTTGGACCCT
CGTCAAGAGCGTTGTAGGTCATTA -> GTCAAGAGCGTTGTAGGTCATTAA
TATGCTACGCCCTGGTCCCTCGAA -> ATGCTACGCCCTGGTCCCTCGAAC
CCTTTACTGGCACAAAAAACTATC -> CTTTACTGGCACAAAAAACTATCG
ACGCCGTACGATGTCAACTGCGTT -> CGCCGTACGATGTCAACTGCGTTT
GAATGCGTCTTGAATAGATACAAA -> AATGCGTCTTGAATAGATACAAAT
ACACGCGCTCTCTCGGCATACTAG -> CACGCGCTCTCTCGGCATACTAGC
CACCTGAACGAACGTACGCATCTG -> ACCTGAACGAACGTACGCATCTGC
TTCTTTACTTCCGGACACGCGCTC -> TCTTTACTTCCGGACACGCGCTCT
TATCACGATCGTATTTGGTTTGCA -> ATCACGATCGTATTTGGTTTGCAC
AGCCTACGCCAGGTCTTTCGACGT -> GCCTACGCCAGGTCTTTCGACGTA
TTGGATCGCGTAAGGGCACATGCG -> TGGATCGCGTAAGGGCACATGCGA
TGCTGTTTCCGCTGTGTGAGACTC -> GCTGTTTCCGCTGTGTGAGACTCG
AGTTAGCCTACGCATCTTACTATT -> GTTAGCCTACGCATCTTACTATTC
GTTTTCATTAAACAAACACCTTTT -> TTTTCATTAAACAAACACCTTTTA
GGCACATGCGAGGAGATATTTATG -> GCACATGCGAGGAGATATTTATGC
TAGAAGTAGCTTGGATCGCGTAAG -> AGAAGTAGCTTGGATCGCGTAAGG
ATTGTTCTTATATCGATCCGGATA -> TTGTTCTTATATCGATCCGGATAG
ATTAATAAGGTGACTCTTAAAAAG -> TTAATAAGGTGACTCTTAAAAAGC
TCTTATATCGATCCGGATAGCACA -> CTTATATCGATCCGGATAGCACAG
AACTGTTTACCGGGCCAGCGCGGC -> ACTGTTTACCGGGCCAGCGCGGCC
CGCTCGCCTGACGGTTCGGCAGTA -> GCTCGCCTGACGGTTCGGCAGTAG
CACGGCCAGCCTTTACTGGCACAA -> ACGGCCAGCCTTTACTGGCACAAA
CGGTTCACCTGAACGAACGTACGC -> GGTTCACCTGAACGAACGTACGCA
CTCCTACAGATCCGATTTTGGGCG -> TCCTACAGATCCGATTTTGGGCGG
TACTGGCACAAAAAACTATCGTAC -> ACTGGCACAAAAAACTATCGTACG
GCGTCTTGAATAGATACAAATCGG -> CGTCTTGAATAGATACAAATCGGT
ATCCAATCGCTCGCCTGACGGTTC -> TCCAATCGCTCGCCTGACGGTTCG
CGTGCACCCCTATCACGATCGTAT -> GTGCACCCCTATCACGATCGTATT
ACACCTGTAGCCCGTGGGCCATCT -> CACCTGTAGCCCGTGGGCCATCTC
ATATTTATGCTACGCCCTGGTCCC -> TATTTATGCTACGCCCTGGTCCCT
TCCGAAGGAACACTAGCGGTTCAC -> CCGAAGGAACACTAGCGGTTCACC
CGCAATATCTTGGACCCTGATCAT -> GCAATATCTTGGACCCTGATCATT
CATCTTACTATTCCTGACGGACTC -> ATCTTACTATTCCTGACGGACTCC
GTAAGGGCACATGCGAGGAGATAT -> TAAGGGCACATGCGAGGAGATATT
TGACTCTTAAAAAGCAAGGTAGAG -> GACTCTTAAAAAGCAAGGTAGAGA
GCAAGTTAGCCTACGCATCTTACT -> CAAGTTAGCCTACGCATCTTACTA
TACACGCTGCTCGAATGCGTCTTG -> ACACGCTGCTCGAATGCGTCTTGA
GGGCCATCTCTTCTCGCAATATCT -> GGCCATCTCTTCTCGCAATATCTT
ATCACGATCGTATTTGGTTTGCAC -> TCACGATCGTATTTGGTTTGCACT
CAGGCGTTATCCCATAGCCCTTGT -> AGGCGTTATCCCATAGCCCTTGTT
GTCTTTCGACGTATAGTAGGGGTA -> TCTTTCGACGTATAGTAGGGGTAC
TATTTTATCGCTTCGGGAGGTACA -> ATTTTATCGCTTCGGGAGGTACAC
CAAACGTGATATATCCGTTTCTTT -> AAACGTGATATATCCGTTTCTTTA
AAGATCCAGTCACGTACCGTGATC -> AGATCCAGTCACGTACCGTGATCC
CTCCGAAGGAACACTAGCGGTTCA -> TCCGAAGGAACACTAGCGGTTCAC
GATCATTGCTTCTCCACTAGGTTT -> ATCATTGCTTCTCCACTAGGTTTT
ATTTTTACCTCGCAATCTAACGGT -> TTTTTACCTCGCAATCTAACGGTC
ACGGTCACTTCACGGCCAGCCTTT -> CGGTCACTTCACGGCCAGCCTTTA
TTACTGCCGTGAGTCAATGCCTCA -> TACTGCCGTGAGTCAATGCCTCAT
CTCTCTCGGCATACTAGCACTTAC -> TCTCTCGGCATACTAGCACTTACA
CGGAGGGCGTACATCTTGACCGGT -> GGAGGGCGTACATCTTGACCGGTT
ATTCCTGACGGACTCCTACAGATC -> TTCCTGACGGACTCCTACAGATCC
GGTTCACCTGAACGAACGTACGCA -> GTTCACCTGAACGAACGTACGCAT
GCTGCAATCGCGCGTCAAGAGCGT -> CTGCAATCGCGCGTCAAGAGCGTT
TATCTTGGACCCTGATCATTGCTT -> ATCTTGGACCCTGATCATTGCTTC
GACTCGTAAAAATCGGAACGAGAA -> ACTCGTAAAAATCGGAACGAGAAG
AAGCAAGGTAGAGAGGGTGATGGT -> AGCAAGGTAGAGAGGGTGATGGTG
CTTCTATATCCCGGAGACCATCGC -> TTCTATATCCCGGAGACCATCGCG
TTCCCACCACGTCTTTCAAGTACC -> TCCCACCACGTCTTTCAAGTACCA
ACTCGAATCATCCGGTTTAATGGC -> CTCGAATCATCCGGTTTAATGGCT
AGACGTCCTAACCATGGCCATATA -> GACGTCCTAACCATGGCCATATAA
TCCGACGGAGGGCGTACATCTTGA -> CCGACGGAGGGCGTACATCTTGAC
GGTATCTCGAGCGTAGAAGTAGCT -> GTATCTCGAGCGTAGAAGTAGCTT
GTACATCCGGGTCCTGTGAACGCC -> TACATCCGGGTCCTGTGAACGCCT
GCTGTATACAGTCAATTCAGCTGC -> CTGTATACAGTCAATTCAGCTGCT
ATATCTTGGACCCTGATCATTGCT -> TATCTTGGACCCTGATCATTGCTT
TGCGAGGAGATATTTATGCTACGC -> GCGAGGAGATATTTATGCTACGCC
CATCTTGACCGGTTACTAAGAATC -> ATCTTGACCGGTTACTAAGAATCA
AAACACCTTTTACTCGGAGCGCCG -> AACACCTTTTACTCGGAGCGCCGA
TAGGGTTACGCTCTGCGTTCCCAC -> AGGGTTACGCTCTGCGTTCCCACC
CGGGTCCTGTGAACGCCTAATGTC -> GGGTCCTGTGAACGCCTAATGTCA
CCAGCCTTTACTGGCACAAAAAAC -> CAGCCTTTACTGGCACAAAAAACT
CACAGAACATACAGAACTGGCCGC -> ACAGAACATACAGAACTGGCCGCG
GATCGCGTAAGGGCACATGCGAGG -> ATCGCGTAAGGGCACATGCGAGGA
ATCACCCAAGCATGCAGCGATCCG -> TCACCCAAGCATGCAGCGATCCGT
TCTATTGCAACTGGCACGCCGTAC -> CTATTGCAACTGGCACGCCGTACG
GCCGTACGATGTCAACTGCGTTTT -> CCGTACGATGTCAACTGCGTTTTC
GTACGCATCTGCTGTTTCCGCTGT -> TACGCATCTGCTGTTTCCGCTGTG
ATCAGGGGCCGGCATAACCATTGT -> TCAGGGGCCGGCATAACCATTGTT
GGCCAGCGCGGCCATTCTATTGCA -> GCCAGCGCGGCCATTCTATTGCAA
TCGCGCTATACAACAGAAAATACC -> CGCGCTATACAACAGAAAATACCG
CGGCATAACCATTGTTCTTATATC -> GGCATAACCATTGTTCTTATATCG
TGTGCTGTATACAGTCAATTCAGC -> GTGCTGTATACAGTCAATTCAGCT
CTATTCCTGACGGACTCCTACAGA -> TATTCCTGACGGACTCCTACAGAT
GATGGTGTACATCCGGGTCCTGTG -> ATGGTGTACATCCGGGTCCTGTGA
GTAGCTTGGATCGCGTAAGGGCAC -> TAGCTTGGATCGCGTAAGGGCACA
CCAGGTCTTTCGACGTATAGTAGG -> CAGGTCTTTCGACGTATAGTAGGG
TCGCGAATCAGGGGCCGGCATAAC -> CGCGAATCAGGGGCCGGCATAACC
TATAGCTTATAGCTCACAGATTAA -> ATAGCTTATAGCTCACAGATTAAT
ACCATCGCGCAAAATCCCGTTCAA -> CCATCGCGCAAAATCCCGTTCAAT
CGTAGTCTACTGCAAGGGGAGGCA -> GTAGTCTACTGCAAGGGGAGGCAG
TGGATCCATCGTTCTGAGACTGGC -> GGATCCATCGTTCTGAGACTGGCA
CCCCTATCACGATCGTATTTGGTT -> CCCTATCACGATCGTATTTGGTTT
AGATACAAATCGGTGGACCAATTC -> GATACAAATCGGTGGACCAATTCT
CGTGATCCATGACACCTGTAGCCC -> GTGATCCATGACACCTGTAGCCCG
GTTGTAGGTCATTAATAAGGTGAC -> TTGTAGGTCATTAATAAGGTGACT
AATAGTATAAGGAACTACACGCTG -> ATAGTATAAGGAACTACACGCTGC
GAAGGCTAGCTGCAATCGCGCGTC -> AAGGCTAGCTGCAATCGCGCGTCA
CATGCGCGACCGCAAGCGTTGCCA -> ATGCGCGACCGCAAGCGTTGCCAC
AGAAGGCTAGCTGCAATCGCGCGT -> GAAGGCTAGCTGCAATCGCGCGTC
CACCACGTCTTTCAAGTACCAACT -> ACCACGTCTTTCAAGTACCAACTG
TTACAGAAAGACCCAGGGCAGTTC -> TACAGAAAGACCCAGGGCAGTTCC
CCAGCGCGGCCATTCTATTGCAAC -> CAGCGCGGCCATTCTATTGCAACT
CAAATCGGTGGACCAATTCTAGAA -> AAATCGGTGGACCAATTCTAGAAT
CAAGTTAGCCTACGCATCTTACTA -> AAGTTAGCCTACGCATCTTACTAT
GTAGTCTACTGCAAGGGGAGGCAG -> TAGTCTACTGCAAGGGGAGGCAGG
CTCGCGCTATACAACAGAAAATAC -> TCGCGCTATACAACAGAAAATACC
GTAAAGATCGACGGCTGGGTGACC -> TAAAGATCGACGGCTGGGTGACCA
ATGGCCATATAAATATTTTCCCTG -> TGGCCATATAAATATTTTCCCTGT
ATTCAGCTGCTCCGAAGGAACACT -> TTCAGCTGCTCCGAAGGAACACTA
CGGACACGCGCTCTCTCGGCATAC -> GGACACGCGCTCTCTCGGCATACT
TACGCATCTGCTGTTTCCGCTGTG -> ACGCATCTGCTGTTTCCGCTGTGT
ACACCAGAAAGACTAGGCGGGTGA -> CACCAGAAAGACTAGGCGGGTGAC
TTCTGAGACTGGCAACGGCATAAA -> TCTGAGACTGGCAACGGCATAAAG
CTGAACGAACGTACGCATCTGCTG -> TGAACGAACGTACGCATCTGCTGT
ATTCTAGAATGCGTCATCATGATT -> TTCTAGAATGCGTCATCATGATTG
ACGAACGTACGCATCTGCTGTTTC -> CGAACGTACGCATCTGCTGTTTCC
TTGTGTGCTGTATACAGTCAATTC -> TGTGTGCTGTATACAGTCAATTCA
CCTCGCAATCTAACGGTCACTTCA -> CTCGCAATCTAACGGTCACTTCAC
TCTTACTATTCCTGACGGACTCCT -> CTTACTATTCCTGACGGACTCCTA
CGCTTCGGGAGGTACACATTACCG -> GCTTCGGGAGGTACACATTACCGA
TACTCTGCGTGCGCAAGTTAGCCT -> ACTCTGCGTGCGCAAGTTAGCCTA
GGGCAGTTCCGAGCCTACGCCAGG -> GGCAGTTCCGAGCCTACGCCAGGT
ATCGCGCGTCAAGAGCGTTGTAGG -> TCGCGCGTCAAGAGCGTTGTAGGT
TCGTGCAACGGGTATCTCGAGCGT -> CGTGCAACGGGTATCTCGAGCGTA
TCGACGTATAGTAGGGGTACTCGC -> CGACGTATAGTAGGGGTACTCGCT
GAGGGCGTACATCTTGACCGGTTA -> AGGGCGTACATCTTGACCGGTTAC
AGCGATCCGTGCACCCCTATCACG -> GCGATCCGTGCACCCCTATCACGA
GGCATAACCATTGTTCTTATATCG -> GCATAACCATTGTTCTTATATCGA
ACAGATCCGATTTTGGGCGGTGGT -> CAGATCCGATTTTGGGCGGTGGTG
TAGCACTTACACCAGGGGCGCACG -> AGCACTTACACCAGGGGCGCACGC
AGACCCAGGGCAGTTCCGAGCCTA -> GACCCAGGGCAGTTCCGAGCCTAC
AGCGCGGCCATTCTATTGCAACTG -> GCGCGGCCATTCTATTGCAACTGG
TGAGGGTGAGAGACCTGGGACCGC -> GAGGGTGAGAGACCTGGGACCGCC
TATGGAAACCCTGAATCCGACGGA -> ATGGAAACCCTGAATCCGACGGAG
TCTGCTGTTTCCGCTGTGTGAGAC -> CTGCTGTTTCCGCTGTGTGAGACT
GTCAATGCCTCATTGATGGTGTGG -> TCAATGCCTCATTGATGGTGTGGC
TGTGCTACACCAGAAAGACTAGGC -> GTGCTACACCAGAAAGACTAGGCG
GTCGCGAATCAGGGGCCGGCATAA -> TCGCGAATCAGGGGCCGGCATAAC
CTCGTAAAAATCGGAACGAGAAGG -> TCGTAAAAATCGGAACGAGAAGGC
ACGCATCTGCTGTTTCCGCTGTGT -> CGCATCTGCTGTTTCCGCTGTGTG
TCTCGGCATACTAGCACTTACACC -> CTCGGCATACTAGCACTTACACCA
CGATCCGTGCACCCCTATCACGAT -> GATCCGTGCACCCCTATCACGATC
CAGGCTGTATTTACAGAAAGACCC -> AGGCTGTATTTACAGAAAGACCCA
CTTATATCGATCCGGATAGCACAG -> TTATATCGATCCGGATAGCACAGA
CACCAGGGGCGCACGCTCTATGGA -> ACCAGGGGCGCACGCTCTATGGAA
TGTATTTACAGAAAGACCCAGGGC -> GTATTTACAGAAAGACCCAGGGCA
ATCCGTGCACCCCTATCACGATCG -> TCCGTGCACCCCTATCACGATCGT
GAAAATACCGCCATGCGCGACCGC -> AAAATACCGCCATGCGCGACCGCA
GGGGTAGTTCTTCTATATCCCGGA -> GGGTAGTTCTTCTATATCCCGGAG
TACACCAGAAAGACTAGGCGGGTG -> ACACCAGAAAGACTAGGCGGGTGA
GTCAACTGCGTTTTCGTGCAACGG -> TCAACTGCGTTTTCGTGCAACGGG
AACTATCGTACGTGCCTCGGCCCA -> ACTATCGTACGTGCCTCGGCCCAA
TGCTACACCAGAAAGACTAGGCGG -> GCTACACCAGAAAGACTAGGCGGG
TCGCTCGCCTGACGGTTCGGCAGT -> CGCTCGCCTGACGGTTCGGCAGTA
AATAAGGTGACTCTTAAAAAGCAA -> ATAAGGTGACTCTTAAAAAGCAAG
CATGCGAGGAGATATTTATGCTAC -> ATGCGAGGAGATATTTATGCTACG
GATCCATCGTTCTGAGACTGGCAA -> ATCCATCGTTCTGAGACTGGCAAC
TAAAGACGTCCTAACCATGGCCAT -> AAAGACGTCCTAACCATGGCCATA
CGTTGTAGGTCATTAATAAGGTGA -> GTTGTAGGTCATTAATAAGGTGAC
CTGTTTCCGCTGTGTGAGACTCGT -> TGTTTCCGCTGTGTGAGACTCGTA
CTTTCAAGTACCAACTGTTTACCG -> TTTCAAGTACCAACTGTTTACCGG
ACTAGGCGGGTGACATTACTGCCG -> CTAGGCGGGTGACATTACTGCCGT
AATAGATACAAATCGGTGGACCAA -> ATAGATACAAATCGGTGGACCAAT
ACCTAGCAAGGAGCACACGATATA -> CCTAGCAAGGAGCACACGATATAG
GTTATCCCATAGCCCTTGTTACGC -> TTATCCCATAGCCCTTGTTACGCT
TGATTGTGTGCTGTATACAGTCAA -> GATTGTGTGCTGTATACAGTCAAT
CCTACGCCAGGTCTTTCGACGTAT -> CTACGCCAGGTCTTTCGACGTATA
TATGACCTAATAGTATAAGGAACT -> ATGACCTAATAGTATAAGGAACTA
AATCAGGGGCCGGCATAACCATTG -> ATCAGGGGCCGGCATAACCATTGT
GCCATGCGCGACCGCAAGCGTTGC -> CCATGCGCGACCGCAAGCGTTGCC
GACTGGCAACGGCATAAAGACGTC -> ACTGGCAACGGCATAAAGACGTCC
GCCGGCATAACCATTGTTCTTATA -> CCGGCATAACCATTGTTCTTATAT
GAGCCTCCTCATCAGGCGTTATCC -> AGCCTCCTCATCAGGCGTTATCCC
TCCCTGTTAGACCTAGCAAGGAGC -> CCCTGTTAGACCTAGCAAGGAGCA
GATCCGATTTTGGGCGGTGGTGAA -> ATCCGATTTTGGGCGGTGGTGAAC
TTCGGGAGGTACACATTACCGAAA -> TCGGGAGGTACACATTACCGAAAA
CGCATCTTACTATTCCTGACGGAC -> GCATCTTACTATTCCTGACGGACT
TTAATAAGGTGACTCTTAAAAAGC -> TAATAAGGTGACTCTTAAAAAGCA
TCCCACCACGTCTTTCAAGTACCA -> CCCACCACGTCTTTCAAGTACCAA
TGAGACTGGCAACGGCATAAAGAC -> GAGACTGGCAACGGCATAAAGACG
TTATGCTACGCCCTGGTCCCTCGA -> TATGCTACGCCCTGGTCCCTCGAA
TTCTCGCAATATCTTGGACCCTGA -> TCTCGCAATATCTTGGACCCTGAT
GGGGAGGCAGGCTTAGACGCGCAA -> GGGAGGCAGGCTTAGACGCGCAAC
TGCGTAGTCTACTGCAAGGGGAGG -> GCGTAGTCTACTGCAAGGGGAGGC
GCCGCGATACTTCGCGCCAGGCTG -> CCGCGATACTTCGCGCCAGGCTGT
CGAATCATCCGGTTTAATGGCTCG -> GAATCATCCGGTTTAATGGCTCGC
TTAGACCTAGCAAGGAGCACACGA -> TAGACCTAGCAAGGAGCACACGAT
GGTCTTTCGACGTATAGTAGGGGT -> GTCTTTCGACGTATAGTAGGGGTA
AGGAACACTAGCGGTTCACCTGAA -> GGAACACTAGCGGTTCACCTGAAC
ACATGCGAGGAGATATTTATGCTA -> CATGCGAGGAGATATTTATGCTAC
CGGTTACTAAGAATCACCCAAGCA -> GGTTACTAAGAATCACCCAAGCAT
GGTGGACCAATTCTAGAATGCGTC -> GTGGACCAATTCTAGAATGCGTCA
TCGAGCGTAGAAGTAGCTTGGATC -> CGAGCGTAGAAGTAGCTTGGATCG
CATTAAACAAACACCTTTTACTCG -> ATTAAACAAACACCTTTTACTCGG
CGTTTTCGTGCAACGGGTATCTCG -> GTTTTCGTGCAACGGGTATCTCGA
CTGGGACCGCCTATACTCTGCGTG -> TGGGACCGCCTATACTCTGCGTGC
GGTCCTGTGAACGCCTAATGTCAC -> GTCCTGTGAACGCCTAATGTCACG
CGTTTCTTTACTTCCGGACACGCG -> GTTTCTTTACTTCCGGACACGCGC
CTCGAGCGTAGAAGTAGCTTGGAT -> TCGAGCGTAGAAGTAGCTTGGATC
TCGCCTGACGGTTCGGCAGTAGTA -> CGCCTGACGGTTCGGCAGTAGTAG
CTCCACTAGGTTTTCATTAAACAA -> TCCACTAGGTTTTCATTAAACAAA
AAGTTAGCCTACGCATCTTACTAT -> AGTTAGCCTACGCATCTTACTATT
CCTAGCAAGGAGCACACGATATAG -> CTAGCAAGGAGCACACGATATAGC
TCTTGACCGGTTACTAAGAATCAC -> CTTGACCGGTTACTAAGAATCACC
AATCCGTCGCGAATCAGGGGCCGG -> ATCCGTCGCGAATCAGGGGCCGGC
CGCCCTGGTCCCTCGAACACGGCT -> GCCCTGGTCCCTCGAACACGGCTA
TCAATGCCTCATTGATGGTGTGGC -> CAATGCCTCATTGATGGTGTGGCT
GTGCGCAAGTTAGCCTACGCATCT -> TGCGCAAGTTAGCCTACGCATCTT
CATGGGGTAGTTCTTCTATATCCC -> ATGGGGTAGTTCTTCTATATCCCG
TCGAACACGGCTACTTCGAAATCC -> CGAACACGGCTACTTCGAAATCCG
CGCCTGACGGTTCGGCAGTAGTAG -> GCCTGACGGTTCGGCAGTAGTAGT
TAGTGTGTTCTGAGGGTGAGAGAC -> AGTGTGTTCTGAGGGTGAGAGACC
ACGTACGCATCTGCTGTTTCCGCT -> CGTACGCATCTGCTGTTTCCGCTG
ATAGATACAAATCGGTGGACCAAT -> TAGATACAAATCGGTGGACCAATT
AGAGCGTTGTAGGTCATTAATAAG -> GAGCGTTGTAGGTCATTAATAAGG
CCTGGGACCGCCTATACTCTGCGT -> CTGGGACCGCCTATACTCTGCGTG
AGTACGCGAGCATTTTTACCTCGC -> GTACGCGAGCATTTTTACCTCGCA
GAGGAGATATTTATGCTACGCCCT -> AGGAGATATTTATGCTACGCCCTG
CTACTTCGAAATCCGTCGCGAATC -> TACTTCGAAATCCGTCGCGAATCA
TGTCAACTGCGTTTTCGTGCAACG -> GTCAACTGCGTTTTCGTGCAACGG
AGGGTTACGCTCTGCGTTCCCACC -> GGGTTACGCTCTGCGTTCCCACCA
TCATGATTGTGTGCTGTATACAGT -> CATGATTGTGTGCTGTATACAGTC
TATATCGATCCGGATAGCACAGAA -> ATATCGATCCGGATAGCACAGAAC
ACCAGAAAGACTAGGCGGGTGACA -> CCAGAAAGACTAGGCGGGTGACAT
GAGCGCCGAGCCTCCTCATCAGGC -> AGCGCCGAGCCTCCTCATCAGGCG
GACGCGCAACGAAAGATCCAGTCA -> ACGCGCAACGAAAGATCCAGTCAC
ATTAAACAAACACCTTTTACTCGG -> TTAAACAAACACCTTTTACTCGGA
CGGCAGTAGTAGTGTGTTCTGAGG -> GGCAGTAGTAGTGTGTTCTGAGGG
TCGAAATCCGTCGCGAATCAGGGG -> CGAAATCCGTCGCGAATCAGGGGC
CAATCGCTCGCCTGACGGTTCGGC -> AATCGCTCGCCTGACGGTTCGGCA
CCCTGTTAGACCTAGCAAGGAGCA -> CCTGTTAGACCTAGCAAGGAGCAC
GTACCAACTGTTTACCGGGCCAGC -> TACCAACTGTTTACCGGGCCAGCG
GACCTAGCAAGGAGCACACGATAT -> ACCTAGCAAGGAGCACACGATATA
AGCTTATAGCTCACAGATTAATGG -> GCTTATAGCTCACAGATTAATGGG
GTTCCGAGCCTACGCCAGGTCTTT -> TTCCGAGCCTACGCCAGGTCTTTC
CTCACAGATTAATGGGCGTTCTAT -> TCACAGATTAATGGGCGTTCTATG
GTTAGCCTACGCATCTTACTATTC -> TTAGCCTACGCATCTTACTATTCC
AGAATCACCCAAGCATGCAGCGAT -> GAATCACCCAAGCATGCAGCGATC
GTACGCGAGCATTTTTACCTCGCA -> TACGCGAGCATTTTTACCTCGCAA
AAAGCAAGGTAGAGAGGGTGATGG -> AAGCAAGGTAGAGAGGGTGATGGT
CAATCTAACGGTCACTTCACGGCC -> AATCTAACGGTCACTTCACGGCCA
TGTATACAGTCAATTCAGCTGCTC -> GTATACAGTCAATTCAGCTGCTCC
GTAGTTCTTCTATATCCCGGAGAC -> TAGTTCTTCTATATCCCGGAGACC
CATTAATAAGGTGACTCTTAAAAA -> ATTAATAAGGTGACTCTTAAAAAG
CGAAGGAACACTAGCGGTTCACCT -> GAAGGAACACTAGCGGTTCACCTG
GCCGTGAGTCAATGCCTCATTGAT -> CCGTGAGTCAATGCCTCATTGATG
GCCTACGCCAGGTCTTTCGACGTA -> CCTACGCCAGGTCTTTCGACGTAT
CCACTAGGTTTTCATTAAACAAAC -> CACTAGGTTTTCATTAAACAAACA
TGCTGTATACAGTCAATTCAGCTG -> GCTGTATACAGTCAATTCAGCTGC
ATCTGCTGTTTCCGCTGTGTGAGA -> TCTGCTGTTTCCGCTGTGTGAGAC
TGAATCCGACGGAGGGCGTACATC -> GAATCCGACGGAGGGCGTACATCT
ACGCTGCTCGAATGCGTCTTGAAT -> CGCTGCTCGAATGCGTCTTGAATA
AATCGCGCGTCAAGAGCGTTGTAG -> ATCGCGCGTCAAGAGCGTTGTAGG
AACGTGATATATCCGTTTCTTTAC -> ACGTGATATATCCGTTTCTTTACT
TAGACGCGCAACGAAAGATCCAGT -> AGACGCGCAACGAAAGATCCAGTC
AGTAGTAGTGTGTTCTGAGGGTGA -> GTAGTAGTGTGTTCTGAGGGTGAG
CCTATCACGATCGTATTTGGTTTG -> CTATCACGATCGTATTTGGTTTGC
GAACGCCTAATGTCACGATGTAGG -> AACGCCTAATGTCACGATGTAGGC
TATACAGTCAATTCAGCTGCTCCG -> ATACAGTCAATTCAGCTGCTCCGA
CCGTGAGTCAATGCCTCATTGATG -> CGTGAGTCAATGCCTCATTGATGG
TATAGCTCACAGATTAATGGGCGT -> ATAGCTCACAGATTAATGGGCGTT
AGTGTGTTCTGAGGGTGAGAGACC -> GTGTGTTCTGAGGGTGAGAGACCT
GTGTGTTCTGAGGGTGAGAGACCT -> TGTGTTCTGAGGGTGAGAGACCTG
TCCGGTTTAATGGCTCGCGCTATA -> CCGGTTTAATGGCTCGCGCTATAC
CCAGTCACGTACCGTGATCCATGA -> CAGTCACGTACCGTGATCCATGAC
CCTGGTCCCTCGAACACGGCTACT -> CTGGTCCCTCGAACACGGCTACTT
ATTTATGCTACGCCCTGGTCCCTC -> TTTATGCTACGCCCTGGTCCCTCG
GTTTTCGTGCAACGGGTATCTCGA -> TTTTCGTGCAACGGGTATCTCGAG
ATTTTATCGCTTCGGGAGGTACAC -> TTTTATCGCTTCGGGAGGTACACA
TTCCGGACACGCGCTCTCTCGGCA -> TCCGGACACGCGCTCTCTCGGCAT
TTGGTTTGCACTATTTTATCGCTT -> TGGTTTGCACTATTTTATCGCTTC
CGGTGGTGAACTATGACCTAATAG -> GGTGGTGAACTATGACCTAATAGT
TCATTAATAAGGTGACTCTTAAAA -> CATTAATAAGGTGACTCTTAAAAA
AGAACTGGCCGCGATACTTCGCGC -> GAACTGGCCGCGATACTTCGCGCC
CTCGCAATATCTTGGACCCTGATC -> TCGCAATATCTTGGACCCTGATCA
GGTGACATTACTGCCGTGAGTCAA -> GTGACATTACTGCCGTGAGTCAAT
CTTCCGGACACGCGCTCTCTCGGC -> TTCCGGACACGCGCTCTCTCGGCA
TACTCGCTAGCCCTTCGGATCATG -> ACTCGCTAGCCCTTCGGATCATGG
AAATACCGCCATGCGCGACCGCAA -> AATACCGCCATGCGCGACCGCAAG
ATCTCGAGCGTAGAAGTAGCTTGG -> TCTCGAGCGTAGAAGTAGCTTGGA
TCCTACAGATCCGATTTTGGGCGG -> CCTACAGATCCGATTTTGGGCGGT
TAATAGTATAAGGAACTACACGCT -> AATAGTATAAGGAACTACACGCTG
TGACCGGTTACTAAGAATCACCCA -> GACCGGTTACTAAGAATCACCCAA
CAGCCTTTACTGGCACAAAAAACT -> AGCCTTTACTGGCACAAAAAACTA
AGGCCAGGAAAATTCGGTGTGCTA -> GGCCAGGAAAATTCGGTGTGCTAC
GACCCTGATCATTGCTTCTCCACT -> ACCCTGATCATTGCTTCTCCACTA
GGAGGGCGTACATCTTGACCGGTT -> GAGGGCGTACATCTTGACCGGTTA
CCCAAACGTGATATATCCGTTTCT -> CCAAACGTGATATATCCGTTTCTT
TAGTCTACTGCAAGGGGAGGCAGG -> AGTCTACTGCAAGGGGAGGCAGGC
ACGCGAGCATTTTTACCTCGCAAT -> CGCGAGCATTTTTACCTCGCAATC
CAACAGAAAATACCGCCATGCGCG -> AACAGAAAATACCGCCATGCGCGA
CATCCAATCGCTCGCCTGACGGTT -> ATCCAATCGCTCGCCTGACGGTTC
GATCATGGTCGGCCGCCATCCAAT -> ATCATGGTCGGCCGCCATCCAATC
TGATCATTGCTTCTCCACTAGGTT -> GATCATTGCTTCTCCACTAGGTTT
TCGCAATATCTTGGACCCTGATCA -> CGCAATATCTTGGACCCTGATCAT
CTCTATGGAAACCCTGAATCCGAC -> TCTATGGAAACCCTGAATCCGACG
CCCTGAATCCGACGGAGGGCGTAC -> CCTGAATCCGACGGAGGGCGTACA
ATCGGAACGAGAAGGCTAGCTGCA -> TCGGAACGAGAAGGCTAGCTGCAA
ATCCCGTTCAATTATGTAAAGATC -> TCCCGTTCAATTATGTAAAGATCG
GTAGCCCGTGGGCCATCTCTTCTC -> TAGCCCGTGGGCCATCTCTTCTCG
GAGCACACGATATAGCTTATAGCT -> AGCACACGATATAGCTTATAGCTC
TCCGCTGTGTGAGACTCGTAAAAA -> CCGCTGTGTGAGACTCGTAAAAAT
TCTTCTCGCAATATCTTGGACCCT -> CTTCTCGCAATATCTTGGACCCTG
GGCTAGCTGCAATCGCGCGTCAAG -> GCTAGCTGCAATCGCGCGTCAAGA
TTTTCCCTGTTAGACCTAGCAAGG -> TTTCCCTGTTAGACCTAGCAAGGA
CAATCGCGCGTCAAGAGCGTTGTA -> AATCGCGCGTCAAGAGCGTTGTAG
GAGGGTGATGGTGTACATCCGGGT -> AGGGTGATGGTGTACATCCGGGTC
AGGGGCGCACGCTCTATGGAAACC -> GGGGCGCACGCTCTATGGAAACCC
TGTTCTTATATCGATCCGGATAGC -> GTTCTTATATCGATCCGGATAGCA
CGCGCTCTCTCGGCATACTAGCAC -> GCGCTCTCTCGGCATACTAGCACT
GTCAAGAGCGTTGTAGGTCATTAA -> TCAAGAGCGTTGTAGGTCATTAAT
GACCAATTCTAGAATGCGTCATCA -> ACCAATTCTAGAATGCGTCATCAT
GGGCACATGCGAGGAGATATTTAT -> GGCACATGCGAGGAGATATTTATG
CCAACTGTTTACCGGGCCAGCGCG -> CAACTGTTTACCGGGCCAGCGCGG
GTGATCCATGACACCTGTAGCCCG -> TGATCCATGACACCTGTAGCCCGT
TAGCTTATAGCTCACAGATTAATG -> AGCTTATAGCTCACAGATTAATGG
ATCGTACGTGCCTCGGCCCAAACG -> TCGTACGTGCCTCGGCCCAAACGT
ATAGCACAGAACATACAGAACTGG -> TAGCACAGAACATACAGAACTGGC
CACTATTTTATCGCTTCGGGAGGT -> ACTATTTTATCGCTTCGGGAGGTA
CAGAAAATACCGCCATGCGCGACC -> AGAAAATACCGCCATGCGCGACCG
AGTAGTGTGTTCTGAGGGTGAGAG -> GTAGTGTGTTCTGAGGGTGAGAGA
ACTGTTTACCGGGCCAGCGCGGCC -> CTGTTTACCGGGCCAGCGCGGCCA
AATGCCTCATTGATGGTGTGGCTT -> ATGCCTCATTGATGGTGTGGCTTA
CACAAAAAACTATCGTACGTGCCT -> ACAAAAAACTATCGTACGTGCCTC
ACGTGCCTCGGCCCAAACGTGATA -> CGTGCCTCGGCCCAAACGTGATAT
CCTGTTAGACCTAGCAAGGAGCAC -> CTGTTAGACCTAGCAAGGAGCACA
TCCTGTGAACGCCTAATGTCACGA -> CCTGTGAACGCCTAATGTCACGAT
GATCGACGGCTGGGTGACCAACTG -> ATCGACGGCTGGGTGACCAACTGG
GGTGACTCTTAAAAAGCAAGGTAG -> GTGACTCTTAAAAAGCAAGGTAGA
CGACCGCAAGCGTTGCCACACAGT -> GACCGCAAGCGTTGCCACACAGTA
TAGCACAGAACATACAGAACTGGC -> AGCACAGAACATACAGAACTGGCC
TCGGGAGGTACACATTACCGAAAA -> CGGGAGGTACACATTACCGAAAAC
GATATAGCTTATAGCTCACAGATT -> ATATAGCTTATAGCTCACAGATTA
GTTCGGCAGTAGTAGTGTGTTCTG -> TTCGGCAGTAGTAGTGTGTTCTGA
GGATCCATCGTTCTGAGACTGGCA -> GATCCATCGTTCTGAGACTGGCAA
CATTGTTCTTATATCGATCCGGAT -> ATTGTTCTTATATCGATCCGGATA
CGCGCAAAATCCCGTTCAATTATG -> GCGCAAAATCCCGTTCAATTATGT
TCGGAACGAGAAGGCTAGCTGCAA -> CGGAACGAGAAGGCTAGCTGCAAT
AAATTCGGTGTGCTACACCAGAAA -> AATTCGGTGTGCTACACCAGAAAG
ATTACTGCCGTGAGTCAATGCCTC -> TTACTGCCGTGAGTCAATGCCTCA
CGCCATGCGCGACCGCAAGCGTTG -> GCCATGCGCGACCGCAAGCGTTGC
TACAGAAAGACCCAGGGCAGTTCC -> ACAGAAAGACCCAGGGCAGTTCCG
ACCCTGATCATTGCTTCTCCACTA -> CCCTGATCATTGCTTCTCCACTAG
CGCTGTGTGAGACTCGTAAAAATC -> GCTGTGTGAGACTCGTAAAAATCG
GGGCGGTGGTGAACTATGACCTAA -> GGCGGTGGTGAACTATGACCTAAT
CTCGCTAGCCCTTCGGATCATGGT -> TCGCTAGCCCTTCGGATCATGGTC
AGGGGAGGCAGGCTTAGACGCGCA -> GGGGAGGCAGGCTTAGACGCGCAA
GGCTACTTCGAAATCCGTCGCGAA -> GCTACTTCGAAATCCGTCGCGAAT
TCCGATTTTGGGCGGTGGTGAACT -> CCGATTTTGGGCGGTGGTGAACTA
GTGCAACGGGTATCTCGAGCGTAG -> TGCAACGGGTATCTCGAGCGTAGA
GCTACTTCGAAATCCGTCGCGAAT -> CTACTTCGAAATCCGTCGCGAATC
CCTTCGGATCATGGTCGGCCGCCA -> CTTCGGATCATGGTCGGCCGCCAT
ACTGCGTTTTCGTGCAACGGGTAT -> CTGCGTTTTCGTGCAACGGGTATC
TCCTAACCATGGCCATATAAATAT -> CCTAACCATGGCCATATAAATATT
ATGGAAAGGTTGCGTAGTCTACTG -> TGGAAAGGTTGCGTAGTCTACTGC
CATCCGGTTTAATGGCTCGCGCTA -> ATCCGGTTTAATGGCTCGCGCTAT
GCCATATAAATATTTTCCCTGTTA -> CCATATAAATATTTTCCCTGTTAG
TAGCCTACGCATCTTACTATTCCT -> AGCCTACGCATCTTACTATTCCTG
TCACCTGAACGAACGTACGCATCT -> CACCTGAACGAACGTACGCATCTG
AGGTTGCGTAGTCTACTGCAAGGG -> GGTTGCGTAGTCTACTGCAAGGGG
GGCATAAAGACGTCCTAACCATGG -> GCATAAAGACGTCCTAACCATGGC
ATCCATGACACCTGTAGCCCGTGG -> TCCATGACACCTGTAGCCCGTGGG
GCGCGGCCATTCTATTGCAACTGG -> CGCGGCCATTCTATTGCAACTGGC
ACCGGTTACTAAGAATCACCCAAG -> CCGGTTACTAAGAATCACCCAAGC
ACGATCGTATTTGGTTTGCACTAT -> CGATCGTATTTGGTTTGCACTATT
GGGGCGCACGCTCTATGGAAACCC -> GGGCGCACGCTCTATGGAAACCCT
CCAGGGCAGTTCCGAGCCTACGCC -> CAGGGCAGTTCCGAGCCTACGCCA
TCAGCTTATAGGGTTACGCTCTGC -> CAGCTTATAGGGTTACGCTCTGCG
CTAACCATGGCCATATAAATATTT -> TAACCATGGCCATATAAATATTTT
CGTGGGCCATCTCTTCTCGCAATA -> GTGGGCCATCTCTTCTCGCAATAT
GCAACTGGCACGCCGTACGATGTC -> CAACTGGCACGCCGTACGATGTCA
AATGCGTCTTGAATAGATACAAAT -> ATGCGTCTTGAATAGATACAAATC
TTACTATTCCTGACGGACTCCTAC -> TACTATTCCTGACGGACTCCTACA
GCGGTTCACCTGAACGAACGTACG -> CGGTTCACCTGAACGAACGTACGC
CCCAAGCATGCAGCGATCCGTGCA -> CCAAGCATGCAGCGATCCGTGCAC
GACCGGTTACTAAGAATCACCCAA -> ACCGGTTACTAAGAATCACCCAAG
TTCCCTGTTAGACCTAGCAAGGAG -> TCCCTGTTAGACCTAGCAAGGAGC
GCACAAAAAACTATCGTACGTGCC -> CACAAAAAACTATCGTACGTGCCT
GCAATCTAACGGTCACTTCACGGC -> CAATCTAACGGTCACTTCACGGCC
AATTATGTAAAGATCGACGGCTGG -> ATTATGTAAAGATCGACGGCTGGG
CCTACAGATCCGATTTTGGGCGGT -> CTACAGATCCGATTTTGGGCGGTG
AAAAATCGGAACGAGAAGGCTAGC -> AAAATCGGAACGAGAAGGCTAGCT
CTTGGACCCTGATCATTGCTTCTC -> TTGGACCCTGATCATTGCTTCTCC
GAAAGATCCAGTCACGTACCGTGA -> AAAGATCCAGTCACGTACCGTGAT
TTTACAGAAAGACCCAGGGCAGTT -> TTACAGAAAGACCCAGGGCAGTTC
CTGAATCCGACGGAGGGCGTACAT -> TGAATCCGACGGAGGGCGTACATC
GATGTAGGCCAGGAAAATTCGGTG -> ATGTAGGCCAGGAAAATTCGGTGT
GGAGACCATCGCGCAAAATCCCGT -> GAGACCATCGCGCAAAATCCCGTT
GGCTTAGTACGCGAGCATTTTTAC -> GCTTAGTACGCGAGCATTTTTACC
GGGCGCACGCTCTATGGAAACCCT -> GGCGCACGCTCTATGGAAACCCTG
ATCATGATTGTGTGCTGTATACAG -> TCATGATTGTGTGCTGTATACAGT
TGCTCCGAAGGAACACTAGCGGTT -> GCTCCGAAGGAACACTAGCGGTTC
AAGGTGACTCTTAAAAAGCAAGGT -> AGGTGACTCTTAAAAAGCAAGGTA
TCTAACGGTCACTTCACGGCCAGC -> CTAACGGTCACTTCACGGCCAGCC
ATAAAGACGTCCTAACCATGGCCA -> TAAAGACGTCCTAACCATGGCCAT
CCGAAGGAACACTAGCGGTTCACC -> CGAAGGAACACTAGCGGTTCACCT
ATGACACCTGTAGCCCGTGGGCCA -> TGACACCTGTAGCCCGTGGGCCAT
TTTATGCTACGCCCTGGTCCCTCG -> TTATGCTACGCCCTGGTCCCTCGA
TCCTGACGGACTCCTACAGATCCG -> CCTGACGGACTCCTACAGATCCGA
TACCGCCATGCGCGACCGCAAGCG -> ACCGCCATGCGCGACCGCAAGCGT
CATGCAGCGATCCGTGCACCCCTA -> ATGCAGCGATCCGTGCACCCCTAT
AATTCGGTGTGCTACACCAGAAAG -> ATTCGGTGTGCTACACCAGAAAGA
ACTCGGAGCGCCGAGCCTCCTCAT -> CTCGGAGCGCCGAGCCTCCTCATC
CTAAGAATCACCCAAGCATGCAGC -> TAAGAATCACCCAAGCATGCAGCG
CCTGACGGTTCGGCAGTAGTAGTG -> CTGACGGTTCGGCAGTAGTAGTGT
TGGACCCTGATCATTGCTTCTCCA -> GGACCCTGATCATTGCTTCTCCAC
GAAACCCTGAATCCGACGGAGGGC -> AAACCCTGAATCCGACGGAGGGCG
TCCCGTTCAATTATGTAAAGATCG -> CCCGTTCAATTATGTAAAGATCGA
ACACGATATAGCTTATAGCTCACA -> CACGATATAGCTTATAGCTCACAG
ACTAAGAATCACCCAAGCATGCAG -> CTAAGAATCACCCAAGCATGCAGC
TGAGACTCGTAAAAATCGGAACGA -> GAGACTCGTAAAAATCGGAACGAG
CAGTATTGACATGGGGTAGTTCTT -> AGTATTGACATGGGGTAGTTCTTC
TCGACGGCTGGGTGACCAACTGGA -> CGACGGCTGGGTGACCAACTGGAT
CTACAGATCCGATTTTGGGCGGTG -> TACAGATCCGATTTTGGGCGGTGG
GCGAGGAGATATTTATGCTACGCC -> CGAGGAGATATTTATGCTACGCCC
TCTGAGGGTGAGAGACCTGGGACC -> CTGAGGGTGAGAGACCTGGGACCG
TAGCTTGGATCGCGTAAGGGCACA -> AGCTTGGATCGCGTAAGGGCACAT
TTCGGTGTGCTACACCAGAAAGAC -> TCGGTGTGCTACACCAGAAAGACT
GTATTTACAGAAAGACCCAGGGCA -> TATTTACAGAAAGACCCAGGGCAG
GGCCGCGATACTTCGCGCCAGGCT -> GCCGCGATACTTCGCGCCAGGCTG
GCGCTCTCTCGGCATACTAGCACT -> CGCTCTCTCGGCATACTAGCACTT
TACAGAACTGGCCGCGATACTTCG -> ACAGAACTGGCCGCGATACTTCGC
GAAAATTCGGTGTGCTACACCAGA -> AAAATTCGGTGTGCTACACCAGAA
CTTCGGGAGGTACACATTACCGAA -> TTCGGGAGGTACACATTACCGAAA
ATGCGAGGAGATATTTATGCTACG -> TGCGAGGAGATATTTATGCTACGC
CATGGCCATATAAATATTTTCCCT -> ATGGCCATATAAATATTTTCCCTG
GCGCGACCGCAAGCGTTGCCACAC -> CGCGACCGCAAGCGTTGCCACACA
CTTACTATTCCTGACGGACTCCTA -> TTACTATTCCTGACGGACTCCTAC
TGACGGTTCGGCAGTAGTAGTGTG -> GACGGTTCGGCAGTAGTAGTGTGT
GACGGACTCCTACAGATCCGATTT -> ACGGACTCCTACAGATCCGATTTT
GTTAGACCTAGCAAGGAGCACACG -> TTAGACCTAGCAAGGAGCACACGA
TTCGGCAGTAGTAGTGTGTTCTGA -> TCGGCAGTAGTAGTGTGTTCTGAG
ATAGTAGGGGTACTCGCTAGCCCT -> TAGTAGGGGTACTCGCTAGCCCTT
ATCCGGATAGCACAGAACATACAG -> TCCGGATAGCACAGAACATACAGA
CGTCTTGAATAGATACAAATCGGT -> GTCTTGAATAGATACAAATCGGTG
CCGTTTCTTTACTTCCGGACACGC -> CGTTTCTTTACTTCCGGACACGCG
TCCTCATCAGGCGTTATCCCATAG -> CCTCATCAGGCGTTATCCCATAGC
CTTGACCGGTTACTAAGAATCACC -> TTGACCGGTTACTAAGAATCACCC
CGTCGCGAATCAGGGGCCGGCATA -> GTCGCGAATCAGGGGCCGGCATAA
CTCGGAGCGCCGAGCCTCCTCATC -> TCGGAGCGCCGAGCCTCCTCATCA
CTCATTGATGGTGTGGCTTAGTAC -> TCATTGATGGTGTGGCTTAGTACG
GCGTAGTCTACTGCAAGGGGAGGC -> CGTAGTCTACTGCAAGGGGAGGCA
CATTACTGCCGTGAGTCAATGCCT -> ATTACTGCCGTGAGTCAATGCCTC
TTAGACGCGCAACGAAAGATCCAG -> TAGACGCGCAACGAAAGATCCAGT
CAAAATCCCGTTCAATTATGTAAA -> AAAATCCCGTTCAATTATGTAAAG
TTCGTGCAACGGGTATCTCGAGCG -> TCGTGCAACGGGTATCTCGAGCGT
TTTACTTCCGGACACGCGCTCTCT -> TTACTTCCGGACACGCGCTCTCTC
CCCAGGGCAGTTCCGAGCCTACGC -> CCAGGGCAGTTCCGAGCCTACGCC
AGGTAGAGAGGGTGATGGTGTACA -> GGTAGAGAGGGTGATGGTGTACAT
GCTTAGTACGCGAGCATTTTTACC -> CTTAGTACGCGAGCATTTTTACCT
TTATATCGATCCGGATAGCACAGA -> TATATCGATCCGGATAGCACAGAA
AACGTACGCATCTGCTGTTTCCGC -> ACGTACGCATCTGCTGTTTCCGCT
TCTTTCAAGTACCAACTGTTTACC -> CTTTCAAGTACCAACTGTTTACCG
GGCCGGCATAACCATTGTTCTTAT -> GCCGGCATAACCATTGTTCTTATA
ATCGTATTTGGTTTGCACTATTTT -> TCGTATTTGGTTTGCACTATTTTA
GTCCCTCGAACACGGCTACTTCGA -> TCCCTCGAACACGGCTACTTCGAA
ACGGAGGGCGTACATCTTGACCGG -> CGGAGGGCGTACATCTTGACCGGT
TCCGTGCACCCCTATCACGATCGT -> CCGTGCACCCCTATCACGATCGTA
ACTGGATCCATCGTTCTGAGACTG -> CTGGATCCATCGTTCTGAGACTGG
ACACGGCTACTTCGAAATCCGTCG -> CACGGCTACTTCGAAATCCGTCGC
ATATCCGTTTCTTTACTTCCGGAC -> TATCCGTTTCTTTACTTCCGGACA
CGGCTACTTCGAAATCCGTCGCGA -> GGCTACTTCGAAATCCGTCGCGAA
GAACGAACGTACGCATCTGCTGTT -> AACGAACGTACGCATCTGCTGTTT
CACCCCTATCACGATCGTATTTGG -> ACCCCTATCACGATCGTATTTGGT
CAAGCATGCAGCGATCCGTGCACC -> AAGCATGCAGCGATCCGTGCACCC
CCTGTGAACGCCTAATGTCACGAT -> CTGTGAACGCCTAATGTCACGATG
TGATCCATGACACCTGTAGCCCGT -> GATCCATGACACCTGTAGCCCGTG
ACGTCTTTCAAGTACCAACTGTTT -> CGTCTTTCAAGTACCAACTGTTTA
AGAAAATACCGCCATGCGCGACCG -> GAAAATACCGCCATGCGCGACCGC
ATGGCTCGCGCTATACAACAGAAA -> TGGCTCGCGCTATACAACAGAAAA
GAGAGGGTGATGGTGTACATCCGG -> AGAGGGTGATGGTGTACATCCGGG
GGAACACTAGCGGTTCACCTGAAC -> GAACACTAGCGGTTCACCTGAACG
GGGTGACATTACTGCCGTGAGTCA -> GGTGACATTACTGCCGTGAGTCAA
TTACTTCCGGACACGCGCTCTCTC -> TACTTCCGGACACGCGCTCTCTCG
TCCCTCGAACACGGCTACTTCGAA -> CCCTCGAACACGGCTACTTCGAAA
GAACGAGAAGGCTAGCTGCAATCG -> AACGAGAAGGCTAGCTGCAATCGC
AACAAACACCTTTTACTCGGAGCG -> ACAAACACCTTTTACTCGGAGCGC
CATTGCTTCTCCACTAGGTTTTCA -> ATTGCTTCTCCACTAGGTTTTCAT
AACCATTGTTCTTATATCGATCCG -> ACCATTGTTCTTATATCGATCCGG
ACCTGGGACCGCCTATACTCTGCG -> CCTGGGACCGCCTATACTCTGCGT
GACTCTTAAAAAGCAAGGTAGAGA -> ACTCTTAAAAAGCAAGGTAGAGAG
TCGTTCTGAGACTGGCAACGGCAT -> CGTTCTGAGACTGGCAACGGCATA
CGGCCGCCATCCAATCGCTCGCCT -> GGCCGCCATCCAATCGCTCGCCTG
CGGGTATCTCGAGCGTAGAAGTAG -> GGGTATCTCGAGCGTAGAAGTAGC
GGTGATGGTGTACATCCGGGTCCT -> GTGATGGTGTACATCCGGGTCCTG
TAGTACGCGAGCATTTTTACCTCG -> AGTACGCGAGCATTTTTACCTCGC
TTCACGGCCAGCCTTTACTGGCAC -> TCACGGCCAGCCTTTACTGGCACA
GACGTATAGTAGGGGTACTCGCTA -> ACGTATAGTAGGGGTACTCGCTAG
AAGCGTTGCCACACAGTATTGACA -> AGCGTTGCCACACAGTATTGACAT
AAGACCCAGGGCAGTTCCGAGCCT -> AGACCCAGGGCAGTTCCGAGCCTA
AGGGTGAGAGACCTGGGACCGCCT -> GGGTGAGAGACCTGGGACCGCCTA
AAAAACTATCGTACGTGCCTCGGC -> AAAACTATCGTACGTGCCTCGGCC
TGCCTCGGCCCAAACGTGATATAT -> GCCTCGGCCCAAACGTGATATATC
TAAGGAACTACACGCTGCTCGAAT -> AAGGAACTACACGCTGCTCGAATG
CGCTCTATGGAAACCCTGAATCCG -> GCTCTATGGAAACCCTGAATCCGA
GCGTAAGGGCACATGCGAGGAGAT -> CGTAAGGGCACATGCGAGGAGATA
AAAGACGTCCTAACCATGGCCATA -> AAGACGTCCTAACCATGGCCATAT
GCGATACTTCGCGCCAGGCTGTAT -> CGATACTTCGCGCCAGGCTGTATT
ACCTAATAGTATAAGGAACTACAC -> CCTAATAGTATAAGGAACTACACG
GCTGTTTCCGCTGTGTGAGACTCG -> CTGTTTCCGCTGTGTGAGACTCGT
CGATATAGCTTATAGCTCACAGAT -> GATATAGCTTATAGCTCACAGATT
TAGGCGGGTGACATTACTGCCGTG -> AGGCGGGTGACATTACTGCCGTGA
ATTGACATGGGGTAGTTCTTCTAT -> TTGACATGGGGTAGTTCTTCTATA
CCAGGAAAATTCGGTGTGCTACAC -> CAGGAAAATTCGGTGTGCTACACC
CGTGCGCAAGTTAGCCTACGCATC -> GTGCGCAAGTTAGCCTACGCATCT
ACGGCTGGGTGACCAACTGGATCC -> CGGCTGGGTGACCAACTGGATCCA
CCATCGTTCTGAGACTGGCAACGG -> CATCGTTCTGAGACTGGCAACGGC
ACGGTTCGGCAGTAGTAGTGTGTT -> CGGTTCGGCAGTAGTAGTGTGTTC
GAATCACCCAAGCATGCAGCGATC -> AATCACCCAAGCATGCAGCGATCC
AATTCAGCTGCTCCGAAGGAACAC -> ATTCAGCTGCTCCGAAGGAACACT
TGTGTGCTGTATACAGTCAATTCA -> GTGTGCTGTATACAGTCAATTCAG
CGCTAGCCCTTCGGATCATGGTCG -> GCTAGCCCTTCGGATCATGGTCGG
CATCCGGGTCCTGTGAACGCCTAA -> ATCCGGGTCCTGTGAACGCCTAAT
GGAGCGCCGAGCCTCCTCATCAGG -> GAGCGCCGAGCCTCCTCATCAGGC
AACTGCGTTTTCGTGCAACGGGTA -> ACTGCGTTTTCGTGCAACGGGTAT
TCTTCTATATCCCGGAGACCATCG -> CTTCTATATCCCGGAGACCATCGC
ATATTTTCCCTGTTAGACCTAGCA -> TATTTTCCCTGTTAGACCTAGCAA
TAGAATGCGTCATCATGATTGTGT -> AGAATGCGTCATCATGATTGTGTG
ACACGCTGCTCGAATGCGTCTTGA -> CACGCTGCTCGAATGCGTCTTGAA
CCTGACGGACTCCTACAGATCCGA -> CTGACGGACTCCTACAGATCCGAT
AAATCGGAACGAGAAGGCTAGCTG -> AATCGGAACGAGAAGGCTAGCTGC
GTTCTGAGGGTGAGAGACCTGGGA -> TTCTGAGGGTGAGAGACCTGGGAC
AGCATGCAGCGATCCGTGCACCCC -> GCATGCAGCGATCCGTGCACCCCT
TTTACTCGGAGCGCCGAGCCTCCT -> TTACTCGGAGCGCCGAGCCTCCTC
CCGATTTTGGGCGGTGGTGAACTA -> CGATTTTGGGCGGTGGTGAACTAT
GTGCCTCGGCCCAAACGTGATATA -> TGCCTCGGCCCAAACGTGATATAT
ACATCCGGGTCCTGTGAACGCCTA -> CATCCGGGTCCTGTGAACGCCTAA
GAATGCGTCATCATGATTGTGTGC -> AATGCGTCATCATGATTGTGTGCT
GCTCGCGCTATACAACAGAAAATA -> CTCGCGCTATACAACAGAAAATAC
AGAATGCGTCATCATGATTGTGTG -> GAATGCGTCATCATGATTGTGTGC
CCCTATCACGATCGTATTTGGTTT -> CCTATCACGATCGTATTTGGTTTG
GCAGCGATCCGTGCACCCCTATCA -> CAGCGATCCGTGCACCCCTATCAC
TTTTTACCTCGCAATCTAACGGTC -> TTTTACCTCGCAATCTAACGGTCA
GCTCTCTCGGCATACTAGCACTTA -> CTCTCTCGGCATACTAGCACTTAC
CTTTCGACGTATAGTAGGGGTACT -> TTTCGACGTATAGTAGGGGTACTC
ACGCATCTTACTATTCCTGACGGA -> CGCATCTTACTATTCCTGACGGAC
GGAACGAGAAGGCTAGCTGCAATC -> GAACGAGAAGGCTAGCTGCAATCG
CGTAAGGGCACATGCGAGGAGATA -> GTAAGGGCACATGCGAGGAGATAT
GCGTTGCCACACAGTATTGACATG -> CGTTGCCACACAGTATTGACATGG
CTGCGTTCCCACCACGTCTTTCAA -> TGCGTTCCCACCACGTCTTTCAAG
CGAGCCTCCTCATCAGGCGTTATC -> GAGCCTCCTCATCAGGCGTTATCC
ACCTCGCAATCTAACGGTCACTTC -> CCTCGCAATCTAACGGTCACTTCA
GAAAGGTTGCGTAGTCTACTGCAA -> AAAGGTTGCGTAGTCTACTGCAAG
ATTCGGTGTGCTACACCAGAAAGA -> TTCGGTGTGCTACACCAGAAAGAC
ACAGAAAGACCCAGGGCAGTTCCG -> CAGAAAGACCCAGGGCAGTTCCGA
ACATTACTGCCGTGAGTCAATGCC -> CATTACTGCCGTGAGTCAATGCCT
CCGGTTTAATGGCTCGCGCTATAC -> CGGTTTAATGGCTCGCGCTATACA
GGCACGCCGTACGATGTCAACTGC -> GCACGCCGTACGATGTCAACTGCG
CGCGCCAGGCTGTATTTACAGAAA -> GCGCCAGGCTGTATTTACAGAAAG
ATCGATCCGGATAGCACAGAACAT -> TCGATCCGGATAGCACAGAACATA
GTTACGCTCTGCGTTCCCACCACG -> TTACGCTCTGCGTTCCCACCACGT
GCAACGGCATAAAGACGTCCTAAC -> CAACGGCATAAAGACGTCCTAACC
TGGCTTAGTACGCGAGCATTTTTA -> GGCTTAGTACGCGAGCATTTTTAC
TTCCGAGCCTACGCCAGGTCTTTC -> TCCGAGCCTACGCCAGGTCTTTCG
GTATACAGTCAATTCAGCTGCTCC -> TATACAGTCAATTCAGCTGCTCCG
GAGCGTAGAAGTAGCTTGGATCGC -> AGCGTAGAAGTAGCTTGGATCGCG
ATAGCTTATAGCTCACAGATTAAT -> TAGCTTATAGCTCACAGATTAATG
GCCTCGGCCCAAACGTGATATATC -> CCTCGGCCCAAACGTGATATATCC
ATACTTCGCGCCAGGCTGTATTTA -> TACTTCGCGCCAGGCTGTATTTAC
GGGGTACTCGCTAGCCCTTCGGAT -> GGGTACTCGCTAGCCCTTCGGATC
AAGTACCAACTGTTTACCGGGCCA -> AGTACCAACTGTTTACCGGGCCAG
CGATGTAGGCCAGGAAAATTCGGT -> GATGTAGGCCAGGAAAATTCGGTG
CGACGTATAGTAGGGGTACTCGCT -> GACGTATAGTAGGGGTACTCGCTA
GCCGAGCCTCCTCATCAGGCGTTA -> CCGAGCCTCCTCATCAGGCGTTAT
TCGGCCCAAACGTGATATATCCGT -> CGGCCCAAACGTGATATATCCGTT
GGGCCAGCGCGGCCATTCTATTGC -> GGCCAGCGCGGCCATTCTATTGCA
CTTACACCAGGGGCGCACGCTCTA -> TTACACCAGGGGCGCACGCTCTAT
CAGTTCCGAGCCTACGCCAGGTCT -> AGTTCCGAGCCTACGCCAGGTCTT
TTTTACTCGGAGCGCCGAGCCTCC -> TTTACTCGGAGCGCCGAGCCTCCT
CTTAGTACGCGAGCATTTTTACCT -> TTAGTACGCGAGCATTTTTACCTC
GGAAACCCTGAATCCGACGGAGGG -> GAAACCCTGAATCCGACGGAGGGC
AACGAACGTACGCATCTGCTGTTT -> ACGAACGTACGCATCTGCTGTTTC
TCGAATCATCCGGTTTAATGGCTC -> CGAATCATCCGGTTTAATGGCTCG
CTGTTAGACCTAGCAAGGAGCACA -> TGTTAGACCTAGCAAGGAGCACAC
GTAGAGAGGGTGATGGTGTACATC -> TAGAGAGGGTGATGGTGTACATCC
ATACAACAGAAAATACCGCCATGC -> TACAACAGAAAATACCGCCATGCG
GTATCTCGAGCGTAGAAGTAGCTT -> TATCTCGAGCGTAGAAGTAGCTTG
AAGATCGACGGCTGGGTGACCAAC -> AGATCGACGGCTGGGTGACCAACT
TGGTCGGCCGCCATCCAATCGCTC -> GGTCGGCCGCCATCCAATCGCTCG
CTATACAACAGAAAATACCGCCAT -> TATACAACAGAAAATACCGCCATG
AGCACTTACACCAGGGGCGCACGC -> GCACTTACACCAGGGGCGCACGCT
GGCCATCTCTTCTCGCAATATCTT -> GCCATCTCTTCTCGCAATATCTTG
TGGAAACCCTGAATCCGACGGAGG -> GGAAACCCTGAATCCGACGGAGGG
GCTGTATTTACAGAAAGACCCAGG -> CTGTATTTACAGAAAGACCCAGGG
GAGACTGGCAACGGCATAAAGACG -> AGACTGGCAACGGCATAAAGACGT
TGAACGAACGTACGCATCTGCTGT -> GAACGAACGTACGCATCTGCTGTT
CGCCGAGCCTCCTCATCAGGCGTT -> GCCGAGCCTCCTCATCAGGCGTTA
TAGTAGGGGTACTCGCTAGCCCTT -> AGTAGGGGTACTCGCTAGCCCTTC
GGTTGCGTAGTCTACTGCAAGGGG -> GTTGCGTAGTCTACTGCAAGGGGA
TTGACATGGGGTAGTTCTTCTATA -> TGACATGGGGTAGTTCTTCTATAT
CTATGGAAAGGTTGCGTAGTCTAC -> TATGGAAAGGTTGCGTAGTCTACT
CACGCGCTCTCTCGGCATACTAGC -> ACGCGCTCTCTCGGCATACTAGCA
ACTCTGCGTGCGCAAGTTAGCCTA -> CTCTGCGTGCGCAAGTTAGCCTAC
GAACTATGACCTAATAGTATAAGG -> AACTATGACCTAATAGTATAAGGA
CGTTATCCCATAGCCCTTGTTACG -> GTTATCCCATAGCCCTTGTTACGC
ATATAGCTTATAGCTCACAGATTA -> TATAGCTTATAGCTCACAGATTAA
CTAATGTCACGATGTAGGCCAGGA -> TAATGTCACGATGTAGGCCAGGAA
TTGCGTAGTCTACTGCAAGGGGAG -> TGCGTAGTCTACTGCAAGGGGAGG
GGAGGCAGGCTTAGACGCGCAACG -> GAGGCAGGCTTAGACGCGCAACGA
ACGATGTAGGCCAGGAAAATTCGG -> CGATGTAGGCCAGGAAAATTCGGT
TATAGGGTTACGCTCTGCGTTCCC -> ATAGGGTTACGCTCTGCGTTCCCA
TGAATAGATACAAATCGGTGGACC -> GAATAGATACAAATCGGTGGACCA
GCATCTGCTGTTTCCGCTGTGTGA -> CATCTGCTGTTTCCGCTGTGTGAG
CGGATAGCACAGAACATACAGAAC -> GGATAGCACAGAACATACAGAACT
CCGTGGGCCATCTCTTCTCGCAAT -> CGTGGGCCATCTCTTCTCGCAATA
TAAGGTGACTCTTAAAAAGCAAGG -> AAGGTGACTCTTAAAAAGCAAGGT
TACAACAGAAAATACCGCCATGCG -> ACAACAGAAAATACCGCCATGCGC
CCATTCTATTGCAACTGGCACGCC -> CATTCTATTGCAACTGGCACGCCG
CACACAGTATTGACATGGGGTAGT -> ACACAGTATTGACATGGGGTAGTT
CACGATGTAGGCCAGGAAAATTCG -> ACGATGTAGGCCAGGAAAATTCGG
CCGCAAGCGTTGCCACACAGTATT -> CGCAAGCGTTGCCACACAGTATTG
ACGCCTAATGTCACGATGTAGGCC -> CGCCTAATGTCACGATGTAGGCCA
GTACGATGTCAACTGCGTTTTCGT -> TACGATGTCAACTGCGTTTTCGTG
ATCCATCGTTCTGAGACTGGCAAC -> TCCATCGTTCTGAGACTGGCAACG
CACGCTCTATGGAAACCCTGAATC -> ACGCTCTATGGAAACCCTGAATCC
CGTGCAACGGGTATCTCGAGCGTA -> GTGCAACGGGTATCTCGAGCGTAG
AAGAGCGTTGTAGGTCATTAATAA -> AGAGCGTTGTAGGTCATTAATAAG
GATTGTGTGCTGTATACAGTCAAT -> ATTGTGTGCTGTATACAGTCAATT
CGTACGCATCTGCTGTTTCCGCTG -> GTACGCATCTGCTGTTTCCGCTGT
CGTCTTTCAAGTACCAACTGTTTA -> GTCTTTCAAGTACCAACTGTTTAC
TTAGTACGCGAGCATTTTTACCTC -> TAGTACGCGAGCATTTTTACCTCG
ACAAAAAACTATCGTACGTGCCTC -> CAAAAAACTATCGTACGTGCCTCG
TCGGAGCGCCGAGCCTCCTCATCA -> CGGAGCGCCGAGCCTCCTCATCAG
GACACGCGCTCTCTCGGCATACTA -> ACACGCGCTCTCTCGGCATACTAG
GAGGTACACATTACCGAAAACTCG -> AGGTACACATTACCGAAAACTCGA
GTTTACCGGGCCAGCGCGGCCATT -> TTTACCGGGCCAGCGCGGCCATTC
CGATACTTCGCGCCAGGCTGTATT -> GATACTTCGCGCCAGGCTGTATTT
CCGTCGCGAATCAGGGGCCGGCAT -> CGTCGCGAATCAGGGGCCGGCATA
TCTCTTCTCGCAATATCTTGGACC -> CTCTTCTCGCAATATCTTGGACCC
CAATTCAGCTGCTCCGAAGGAACA -> AATTCAGCTGCTCCGAAGGAACAC
CTCGCCTGACGGTTCGGCAGTAGT -> TCGCCTGACGGTTCGGCAGTAGTA
GACCAACTGGATCCATCGTTCTGA -> ACCAACTGGATCCATCGTTCTGAG
CATCAGGCGTTATCCCATAGCCCT -> ATCAGGCGTTATCCCATAGCCCTT
ACTTACACCAGGGGCGCACGCTCT -> CTTACACCAGGGGCGCACGCTCTA
ACATTACCGAAAACTCGAATCATC -> CATTACCGAAAACTCGAATCATCC
TTTTGGGCGGTGGTGAACTATGAC -> TTTGGGCGGTGGTGAACTATGACC
TATGTAAAGATCGACGGCTGGGTG -> ATGTAAAGATCGACGGCTGGGTGA
GATCCATGACACCTGTAGCCCGTG -> ATCCATGACACCTGTAGCCCGTGG
GCTTCTCCACTAGGTTTTCATTAA -> CTTCTCCACTAGGTTTTCATTAAA
AGACCTGGGACCGCCTATACTCTG -> GACCTGGGACCGCCTATACTCTGC
GGGTAGTTCTTCTATATCCCGGAG -> GGTAGTTCTTCTATATCCCGGAGA
TTCAATTATGTAAAGATCGACGGC -> TCAATTATGTAAAGATCGACGGCT
TTCGGATCATGGTCGGCCGCCATC -> TCGGATCATGGTCGGCCGCCATCC
AAAAAGCAAGGTAGAGAGGGTGAT -> AAAAGCAAGGTAGAGAGGGTGATG
GCGCCAGGCTGTATTTACAGAAAG -> CGCCAGGCTGTATTTACAGAAAGA
CGTACGATGTCAACTGCGTTTTCG -> GTACGATGTCAACTGCGTTTTCGT
CTAGGCGGGTGACATTACTGCCGT -> TAGGCGGGTGACATTACTGCCGTG
CCCTTCGGATCATGGTCGGCCGCC -> CCTTCGGATCATGGTCGGCCGCCA
AGACGCGCAACGAAAGATCCAGTC -> GACGCGCAACGAAAGATCCAGTCA
CTGCTCCGAAGGAACACTAGCGGT -> TGCTCCGAAGGAACACTAGCGGTT
TGAACGCCTAATGTCACGATGTAG -> GAACGCCTAATGTCACGATGTAGG
GAGACTCGTAAAAATCGGAACGAG -> AGACTCGTAAAAATCGGAACGAGA
TGCGTCATCATGATTGTGTGCTGT -> GCGTCATCATGATTGTGTGCTGTA
CGCAATCTAACGGTCACTTCACGG -> GCAATCTAACGGTCACTTCACGGC
CACTAGCGGTTCACCTGAACGAAC -> ACTAGCGGTTCACCTGAACGAACG
CAATATCTTGGACCCTGATCATTG -> AATATCTTGGACCCTGATCATTGC
ATATCCCGGAGACCATCGCGCAAA -> TATCCCGGAGACCATCGCGCAAAA
TTCTCCACTAGGTTTTCATTAAAC -> TCTCCACTAGGTTTTCATTAAACA
CTACTGCAAGGGGAGGCAGGCTTA -> TACTGCAAGGGGAGGCAGGCTTAG
CTACGCCCTGGTCCCTCGAACACG -> TACGCCCTGGTCCCTCGAACACGG
CCTGATCATTGCTTCTCCACTAGG -> CTGATCATTGCTTCTCCACTAGGT
GATTAATGGGCGTTCTATGGAAAG -> ATTAATGGGCGTTCTATGGAAAGG
TACGTGCCTCGGCCCAAACGTGAT -> ACGTGCCTCGGCCCAAACGTGATA
TTAAACAAACACCTTTTACTCGGA -> TAAACAAACACCTTTTACTCGGAG
CGCAAGCGTTGCCACACAGTATTG -> GCAAGCGTTGCCACACAGTATTGA
ATTGATGGTGTGGCTTAGTACGCG -> TTGATGGTGTGGCTTAGTACGCGA
AGCAAGGTAGAGAGGGTGATGGTG -> GCAAGGTAGAGAGGGTGATGGTGT
GATCCGGATAGCACAGAACATACA -> ATCCGGATAGCACAGAACATACAG
ATGGTCGGCCGCCATCCAATCGCT -> TGGTCGGCCGCCATCCAATCGCTC
TAGCTGCAATCGCGCGTCAAGAGC -> AGCTGCAATCGCGCGTCAAGAGCG
GGTTACTAAGAATCACCCAAGCAT -> GTTACTAAGAATCACCCAAGCATG
GACCATCGCGCAAAATCCCGTTCA -> ACCATCGCGCAAAATCCCGTTCAA
GCTGCTCCGAAGGAACACTAGCGG -> CTGCTCCGAAGGAACACTAGCGGT
ACTGGCAACGGCATAAAGACGTCC -> CTGGCAACGGCATAAAGACGTCCT
CGCCATCCAATCGCTCGCCTGACG -> GCCATCCAATCGCTCGCCTGACGG
AGCTCACAGATTAATGGGCGTTCT -> GCTCACAGATTAATGGGCGTTCTA
AGCACAGAACATACAGAACTGGCC -> GCACAGAACATACAGAACTGGCCG
GAGCATTTTTACCTCGCAATCTAA -> AGCATTTTTACCTCGCAATCTAAC
TTTATCGCTTCGGGAGGTACACAT -> TTATCGCTTCGGGAGGTACACATT
GCCCGTGGGCCATCTCTTCTCGCA -> CCCGTGGGCCATCTCTTCTCGCAA
CGAGAAGGCTAGCTGCAATCGCGC -> GAGAAGGCTAGCTGCAATCGCGCG
TTTTCGTGCAACGGGTATCTCGAG -> TTTCGTGCAACGGGTATCTCGAGC
CGCGCGTCAAGAGCGTTGTAGGTC -> GCGCGTCAAGAGCGTTGTAGGTCA
CGCCAGGCTGTATTTACAGAAAGA -> GCCAGGCTGTATTTACAGAAAGAC
ATCTTGGACCCTGATCATTGCTTC -> TCTTGGACCCTGATCATTGCTTCT
TAGTTCTTCTATATCCCGGAGACC -> AGTTCTTCTATATCCCGGAGACCA
TATTGCAACTGGCACGCCGTACGA -> ATTGCAACTGGCACGCCGTACGAT
TGATGGTGTGGCTTAGTACGCGAG -> GATGGTGTGGCTTAGTACGCGAGC
GGCGTTATCCCATAGCCCTTGTTA -> GCGTTATCCCATAGCCCTTGTTAC
CTGTTTACCGGGCCAGCGCGGCCA -> TGTTTACCGGGCCAGCGCGGCCAT
CGAATGCGTCTTGAATAGATACAA -> GAATGCGTCTTGAATAGATACAAA
TCTTTCGACGTATAGTAGGGGTAC -> CTTTCGACGTATAGTAGGGGTACT
CTAGCAAGGAGCACACGATATAGC -> TAGCAAGGAGCACACGATATAGCT
TACCGTGATCCATGACACCTGTAG -> ACCGTGATCCATGACACCTGTAGC
TCCATCGTTCTGAGACTGGCAACG -> CCATCGTTCTGAGACTGGCAACGG
CACTTCACGGCCAGCCTTTACTGG -> ACTTCACGGCCAGCCTTTACTGGC
CGAAATCCGTCGCGAATCAGGGGC -> GAAATCCGTCGCGAATCAGGGGCC
ACCGCAAGCGTTGCCACACAGTAT -> CCGCAAGCGTTGCCACACAGTATT
TTGATGGTGTGGCTTAGTACGCGA -> TGATGGTGTGGCTTAGTACGCGAG
GAAAACTCGAATCATCCGGTTTAA -> AAAACTCGAATCATCCGGTTTAAT
ATAGGGTTACGCTCTGCGTTCCCA -> TAGGGTTACGCTCTGCGTTCCCAC
GGTTCGGCAGTAGTAGTGTGTTCT -> GTTCGGCAGTAGTAGTGTGTTCTG
CATATAAATATTTTCCCTGTTAGA -> ATATAAATATTTTCCCTGTTAGAC
ACGATATAGCTTATAGCTCACAGA -> CGATATAGCTTATAGCTCACAGAT
CCTTTTACTCGGAGCGCCGAGCCT -> CTTTTACTCGGAGCGCCGAGCCTC
TCATCATGATTGTGTGCTGTATAC -> CATCATGATTGTGTGCTGTATACA
CCACACAGTATTGACATGGGGTAG -> CACACAGTATTGACATGGGGTAGT
CTTCGAAATCCGTCGCGAATCAGG -> TTCGAAATCCGTCGCGAATCAGGG
TGCTTCTCCACTAGGTTTTCATTA -> GCTTCTCCACTAGGTTTTCATTAA
ATGCCTCATTGATGGTGTGGCTTA -> TGCCTCATTGATGGTGTGGCTTAG
TCAATTCAGCTGCTCCGAAGGAAC -> CAATTCAGCTGCTCCGAAGGAACA
TAATAAGGTGACTCTTAAAAAGCA -> AATAAGGTGACTCTTAAAAAGCAA
CGTGCCTCGGCCCAAACGTGATAT -> GTGCCTCGGCCCAAACGTGATATA
TCGGTGTGCTACACCAGAAAGACT -> CGGTGTGCTACACCAGAAAGACTA
TTATAGCTCACAGATTAATGGGCG -> TATAGCTCACAGATTAATGGGCGT
GCAAAATCCCGTTCAATTATGTAA -> CAAAATCCCGTTCAATTATGTAAA
TTAGCCTACGCATCTTACTATTCC -> TAGCCTACGCATCTTACTATTCCT
CAAGGTAGAGAGGGTGATGGTGTA -> AAGGTAGAGAGGGTGATGGTGTAC
CTATGGAAACCCTGAATCCGACGG -> TATGGAAACCCTGAATCCGACGGA
TAAATATTTTCCCTGTTAGACCTA -> AAATATTTTCCCTGTTAGACCTAG
ACTTCCGGACACGCGCTCTCTCGG -> CTTCCGGACACGCGCTCTCTCGGC
TCTGCGTTCCCACCACGTCTTTCA -> CTGCGTTCCCACCACGTCTTTCAA
ATGTCAACTGCGTTTTCGTGCAAC -> TGTCAACTGCGTTTTCGTGCAACG
TTCTTCTATATCCCGGAGACCATC -> TCTTCTATATCCCGGAGACCATCG
ACCTTTTACTCGGAGCGCCGAGCC -> CCTTTTACTCGGAGCGCCGAGCCT
TCTATGGAAAGGTTGCGTAGTCTA -> CTATGGAAAGGTTGCGTAGTCTAC
GCCCTGGTCCCTCGAACACGGCTA -> CCCTGGTCCCTCGAACACGGCTAC
AAAAGCAAGGTAGAGAGGGTGATG -> AAAGCAAGGTAGAGAGGGTGATGG
GCAATCGCGCGTCAAGAGCGTTGT -> CAATCGCGCGTCAAGAGCGTTGTA
GTATAAGGAACTACACGCTGCTCG -> TATAAGGAACTACACGCTGCTCGA
ATGCTACGCCCTGGTCCCTCGAAC -> TGCTACGCCCTGGTCCCTCGAACA
TAAACAAACACCTTTTACTCGGAG -> AAACAAACACCTTTTACTCGGAGC
GCGTTCTATGGAAAGGTTGCGTAG -> CGTTCTATGGAAAGGTTGCGTAGT
GGCGTTCTATGGAAAGGTTGCGTA -> GCGTTCTATGGAAAGGTTGCGTAG
GAGGGTGAGAGACCTGGGACCGCC -> AGGGTGAGAGACCTGGGACCGCCT
AGGCTTAGACGCGCAACGAAAGAT -> GGCTTAGACGCGCAACGAAAGATC
CCAATCGCTCGCCTGACGGTTCGG -> CAATCGCTCGCCTGACGGTTCGGC
TGGCAACGGCATAAAGACGTCCTA -> GGCAACGGCATAAAGACGTCCTAA
CCGCGATACTTCGCGCCAGGCTGT -> CGCGATACTTCGCGCCAGGCTGTA
CCGGAGACCATCGCGCAAAATCCC -> CGGAGACCATCGCGCAAAATCCCG
AAGTAGCTTGGATCGCGTAAGGGC -> AGTAGCTTGGATCGCGTAAGGGCA
CGCGGCCATTCTATTGCAACTGGC -> GCGGCCATTCTATTGCAACTGGCA
TCTCGAGCGTAGAAGTAGCTTGGA -> CTCGAGCGTAGAAGTAGCTTGGAT
ATCTAACGGTCACTTCACGGCCAG -> TCTAACGGTCACTTCACGGCCAGC
ATAAGGTGACTCTTAAAAAGCAAG -> TAAGGTGACTCTTAAAAAGCAAGG
TGTTTACCGGGCCAGCGCGGCCAT -> GTTTACCGGGCCAGCGCGGCCATT
ACGGGTATCTCGAGCGTAGAAGTA -> CGGGTATCTCGAGCGTAGAAGTAG
GCCAGCCTTTACTGGCACAAAAAA -> CCAGCCTTTACTGGCACAAAAAAC
ATACTCTGCGTGCGCAAGTTAGCC -> TACTCTGCGTGCGCAAGTTAGCCT
AAACAAACACCTTTTACTCGGAGC -> AACAAACACCTTTTACTCGGAGCG
GCGTCATCATGATTGTGTGCTGTA -> CGTCATCATGATTGTGTGCTGTAT
ATCCGTCGCGAATCAGGGGCCGGC -> TCCGTCGCGAATCAGGGGCCGGCA
TGCGTCTTGAATAGATACAAATCG -> GCGTCTTGAATAGATACAAATCGG
AGTAGGGGTACTCGCTAGCCCTTC -> GTAGGGGTACTCGCTAGCCCTTCG
AATCTAACGGTCACTTCACGGCCA -> ATCTAACGGTCACTTCACGGCCAG
CGAAAGATCCAGTCACGTACCGTG -> GAAAGATCCAGTCACGTACCGTGA
CGAGCATTTTTACCTCGCAATCTA -> GAGCATTTTTACCTCGCAATCTAA
CGGAGACCATCGCGCAAAATCCCG -> GGAGACCATCGCGCAAAATCCCGT
CCGAGCCTACGCCAGGTCTTTCGA -> CGAGCCTACGCCAGGTCTTTCGAC
GCTGTGTGAGACTCGTAAAAATCG -> CTGTGTGAGACTCGTAAAAATCGG
ATCTCTTCTCGCAATATCTTGGAC -> TCTCTTCTCGCAATATCTTGGACC
CTACACCAGAAAGACTAGGCGGGT -> TACACCAGAAAGACTAGGCGGGTG
CTAGCGGTTCACCTGAACGAACGT -> TAGCGGTTCACCTGAACGAACGTA
ACTATTCCTGACGGACTCCTACAG -> CTATTCCTGACGGACTCCTACAGA
ACCAATTCTAGAATGCGTCATCAT -> CCAATTCTAGAATGCGTCATCATG
CCGGATAGCACAGAACATACAGAA -> CGGATAGCACAGAACATACAGAAC
CAGCTTATAGGGTTACGCTCTGCG -> AGCTTATAGGGTTACGCTCTGCGT
AACTGGATCCATCGTTCTGAGACT -> ACTGGATCCATCGTTCTGAGACTG
CAAGGAGCACACGATATAGCTTAT -> AAGGAGCACACGATATAGCTTATA
GCTGCTCGAATGCGTCTTGAATAG -> CTGCTCGAATGCGTCTTGAATAGA
AAGGTAGAGAGGGTGATGGTGTAC -> AGGTAGAGAGGGTGATGGTGTACA
CTAGCTGCAATCGCGCGTCAAGAG -> TAGCTGCAATCGCGCGTCAAGAGC
CGTACATCTTGACCGGTTACTAAG -> GTACATCTTGACCGGTTACTAAGA
GTCTTTCAAGTACCAACTGTTTAC -> TCTTTCAAGTACCAACTGTTTACC
TGCCTCATTGATGGTGTGGCTTAG -> GCCTCATTGATGGTGTGGCTTAGT
GATCCGTGCACCCCTATCACGATC -> ATCCGTGCACCCCTATCACGATCG
ATCGCTTCGGGAGGTACACATTAC -> TCGCTTCGGGAGGTACACATTACC
GTACACATTACCGAAAACTCGAAT -> TACACATTACCGAAAACTCGAATC
AAGTCAGCTTATAGGGTTACGCTC -> AGTCAGCTTATAGGGTTACGCTCT
ACTCGCTAGCCCTTCGGATCATGG -> CTCGCTAGCCCTTCGGATCATGGT
AGCCTTTACTGGCACAAAAAACTA -> GCCTTTACTGGCACAAAAAACTAT
CAAGCGTTGCCACACAGTATTGAC -> AAGCGTTGCCACACAGTATTGACA
CCGGACACGCGCTCTCTCGGCATA -> CGGACACGCGCTCTCTCGGCATAC
TAGAGAGGGTGATGGTGTACATCC -> AGAGAGGGTGATGGTGTACATCCG
GGGGCCGGCATAACCATTGTTCTT -> GGGCCGGCATAACCATTGTTCTTA
CACCTTTTACTCGGAGCGCCGAGC -> ACCTTTTACTCGGAGCGCCGAGCC
GCCTTTACTGGCACAAAAAACTAT -> CCTTTACTGGCACAAAAAACTATC
GAGGCAGGCTTAGACGCGCAACGA -> AGGCAGGCTTAGACGCGCAACGAA
CGTTCTATGGAAAGGTTGCGTAGT -> GTTCTATGGAAAGGTTGCGTAGTC
TCGCGCGTCAAGAGCGTTGTAGGT -> CGCGCGTCAAGAGCGTTGTAGGTC
GTAGTGTGTTCTGAGGGTGAGAGA -> TAGTGTGTTCTGAGGGTGAGAGAC
TGCAAGGGGAGGCAGGCTTAGACG -> GCAAGGGGAGGCAGGCTTAGACGC
TCAGGCGTTATCCCATAGCCCTTG -> CAGGCGTTATCCCATAGCCCTTGT
GATATTTATGCTACGCCCTGGTCC -> ATATTTATGCTACGCCCTGGTCCC
CTAACGGTCACTTCACGGCCAGCC -> TAACGGTCACTTCACGGCCAGCCT
ATCTTGACCGGTTACTAAGAATCA -> TCTTGACCGGTTACTAAGAATCAC
TGGTGAACTATGACCTAATAGTAT -> GGTGAACTATGACCTAATAGTATA
TAGATACAAATCGGTGGACCAATT -> AGATACAAATCGGTGGACCAATTC
CCCACCACGTCTTTCAAGTACCAA -> CCACCACGTCTTTCAAGTACCAAC
GTTTCTTTACTTCCGGACACGCGC -> TTTCTTTACTTCCGGACACGCGCT
TCGGCATACTAGCACTTACACCAG -> CGGCATACTAGCACTTACACCAGG
CCCTGGTCCCTCGAACACGGCTAC -> CCTGGTCCCTCGAACACGGCTACT
ATACCGCCATGCGCGACCGCAAGC -> TACCGCCATGCGCGACCGCAAGCG
ACTCTTAAAAAGCAAGGTAGAGAG -> CTCTTAAAAAGCAAGGTAGAGAGG
GGTGACCAACTGGATCCATCGTTC -> GTGACCAACTGGATCCATCGTTCT
TTAATGGCTCGCGCTATACAACAG -> TAATGGCTCGCGCTATACAACAGA
ATCGCGCAAAATCCCGTTCAATTA -> TCGCGCAAAATCCCGTTCAATTAT
GGCGGTGGTGAACTATGACCTAAT -> GCGGTGGTGAACTATGACCTAATA
GAAGTAGCTTGGATCGCGTAAGGG -> AAGTAGCTTGGATCGCGTAAGGGC
ATAGTATAAGGAACTACACGCTGC -> TAGTATAAGGAACTACACGCTGCT
AACGCCTAATGTCACGATGTAGGC -> ACGCCTAATGTCACGATGTAGGCC
GACATGGGGTAGTTCTTCTATATC -> ACATGGGGTAGTTCTTCTATATCC
GGCCCAAACGTGATATATCCGTTT -> GCCCAAACGTGATATATCCGTTTC
ATTTGGTTTGCACTATTTTATCGC -> TTTGGTTTGCACTATTTTATCGCT
TATACAACAGAAAATACCGCCATG -> ATACAACAGAAAATACCGCCATGC
TTGACCGGTTACTAAGAATCACCC -> TGACCGGTTACTAAGAATCACCCA
CTAATAGTATAAGGAACTACACGC -> TAATAGTATAAGGAACTACACGCT
CGACGGAGGGCGTACATCTTGACC -> GACGGAGGGCGTACATCTTGACCG
CGTACGTGCCTCGGCCCAAACGTG -> GTACGTGCCTCGGCCCAAACGTGA
ACGCCCTGGTCCCTCGAACACGGC -> CGCCCTGGTCCCTCGAACACGGCT
ATGGGGTAGTTCTTCTATATCCCG -> TGGGGTAGTTCTTCTATATCCCGG
ATTCTATTGCAACTGGCACGCCGT -> TTCTATTGCAACTGGCACGCCGTA
ATCCGGTTTAATGGCTCGCGCTAT -> TCCGGTTTAATGGCTCGCGCTATA
CGTACCGTGATCCATGACACCTGT -> GTACCGTGATCCATGACACCTGTA
TCCGGGTCCTGTGAACGCCTAATG -> CCGGGTCCTGTGAACGCCTAATGT
TTTGGTTTGCACTATTTTATCGCT -> TTGGTTTGCACTATTTTATCGCTT
ACCAGGGGCGCACGCTCTATGGAA -> CCAGGGGCGCACGCTCTATGGAAA
CGATTTTGGGCGGTGGTGAACTAT -> GATTTTGGGCGGTGGTGAACTATG
TGTAGGTCATTAATAAGGTGACTC -> GTAGGTCATTAATAAGGTGACTCT
CATACAGAACTGGCCGCGATACTT -> ATACAGAACTGGCCGCGATACTTC
CCTCCTCATCAGGCGTTATCCCAT -> CTCCTCATCAGGCGTTATCCCATA
TCAACTGCGTTTTCGTGCAACGGG -> CAACTGCGTTTTCGTGCAACGGGT
GAACATACAGAACTGGCCGCGATA -> AACATACAGAACTGGCCGCGATAC
GGTGGTGAACTATGACCTAATAGT -> GTGGTGAACTATGACCTAATAGTA
GCCTGACGGTTCGGCAGTAGTAGT -> CCTGACGGTTCGGCAGTAGTAGTG
AGTCAATGCCTCATTGATGGTGTG -> GTCAATGCCTCATTGATGGTGTGG
CTCGAATGCGTCTTGAATAGATAC -> TCGAATGCGTCTTGAATAGATACA
GGTCGGCCGCCATCCAATCGCTCG -> GTCGGCCGCCATCCAATCGCTCGC
TACACCAGGGGCGCACGCTCTATG -> ACACCAGGGGCGCACGCTCTATGG
AGCTGCAATCGCGCGTCAAGAGCG -> GCTGCAATCGCGCGTCAAGAGCGT
GACCTGGGACCGCCTATACTCTGC -> ACCTGGGACCGCCTATACTCTGCG
CTGCAAGGGGAGGCAGGCTTAGAC -> TGCAAGGGGAGGCAGGCTTAGACG
AACGGGTATCTCGAGCGTAGAAGT -> ACGGGTATCTCGAGCGTAGAAGTA
TGACATTACTGCCGTGAGTCAATG -> GACATTACTGCCGTGAGTCAATGC
CTTGAATAGATACAAATCGGTGGA -> TTGAATAGATACAAATCGGTGGAC
ACGCGCAACGAAAGATCCAGTCAC -> CGCGCAACGAAAGATCCAGTCACG
CAGGGGCCGGCATAACCATTGTTC -> AGGGGCCGGCATAACCATTGTTCT
GTATAGTAGGGGTACTCGCTAGCC -> TATAGTAGGGGTACTCGCTAGCCC
TTACCGGGCCAGCGCGGCCATTCT -> TACCGGGCCAGCGCGGCCATTCTA
GGGCGTTCTATGGAAAGGTTGCGT -> GGCGTTCTATGGAAAGGTTGCGTA
GTGGGCCATCTCTTCTCGCAATAT -> TGGGCCATCTCTTCTCGCAATATC
TATTCCTGACGGACTCCTACAGAT -> ATTCCTGACGGACTCCTACAGATC
GCCCAAACGTGATATATCCGTTTC -> CCCAAACGTGATATATCCGTTTCT
CGGTTTAATGGCTCGCGCTATACA -> GGTTTAATGGCTCGCGCTATACAA
TGGCACAAAAAACTATCGTACGTG -> GGCACAAAAAACTATCGTACGTGC
AATTCTAGAATGCGTCATCATGAT -> ATTCTAGAATGCGTCATCATGATT
GCAAGCGTTGCCACACAGTATTGA -> CAAGCGTTGCCACACAGTATTGAC
TCACCCAAGCATGCAGCGATCCGT -> CACCCAAGCATGCAGCGATCCGTG
TATATCCCGGAGACCATCGCGCAA -> ATATCCCGGAGACCATCGCGCAAA
AGCGTTGCCACACAGTATTGACAT -> GCGTTGCCACACAGTATTGACATG
GCGTTTTCGTGCAACGGGTATCTC -> CGTTTTCGTGCAACGGGTATCTCG
ACCCCTATCACGATCGTATTTGGT -> CCCCTATCACGATCGTATTTGGTT
GCACGCCGTACGATGTCAACTGCG -> CACGCCGTACGATGTCAACTGCGT
GTTTCCGCTGTGTGAGACTCGTAA -> TTTCCGCTGTGTGAGACTCGTAAA
GGACCCTGATCATTGCTTCTCCAC -> GACCCTGATCATTGCTTCTCCACT
AGCAAGGAGCACACGATATAGCTT -> GCAAGGAGCACACGATATAGCTTA
GCACGCTCTATGGAAACCCTGAAT -> CACGCTCTATGGAAACCCTGAATC
GTGATGGTGTACATCCGGGTCCTG -> TGATGGTGTACATCCGGGTCCTGT
GTATTGACATGGGGTAGTTCTTCT -> TATTGACATGGGGTAGTTCTTCTA
TGCGCGACCGCAAGCGTTGCCACA -> GCGCGACCGCAAGCGTTGCCACAC
TCGGCAGTAGTAGTGTGTTCTGAG -> CGGCAGTAGTAGTGTGTTCTGAGG
TTGTAGGTCATTAATAAGGTGACT -> TGTAGGTCATTAATAAGGTGACTC
AGTATTGACATGGGGTAGTTCTTC -> GTATTGACATGGGGTAGTTCTTCT
CGATGTCAACTGCGTTTTCGTGCA -> GATGTCAACTGCGTTTTCGTGCAA
TTCTATTGCAACTGGCACGCCGTA -> TCTATTGCAACTGGCACGCCGTAC
TGTGGCTTAGTACGCGAGCATTTT -> GTGGCTTAGTACGCGAGCATTTTT
ATTGCTTCTCCACTAGGTTTTCAT -> TTGCTTCTCCACTAGGTTTTCATT
CAACTGGCACGCCGTACGATGTCA -> AACTGGCACGCCGTACGATGTCAA
TAATGGCTCGCGCTATACAACAGA -> AATGGCTCGCGCTATACAACAGAA
GTGAGTCAATGCCTCATTGATGGT -> TGAGTCAATGCCTCATTGATGGTG
GTTCACCTGAACGAACGTACGCAT -> TTCACCTGAACGAACGTACGCATC
TTCTTATATCGATCCGGATAGCAC -> TCTTATATCGATCCGGATAGCACA
ACTAGCGGTTCACCTGAACGAACG -> CTAGCGGTTCACCTGAACGAACGT
AGACCATCGCGCAAAATCCCGTTC -> GACCATCGCGCAAAATCCCGTTCA
GGCCATATAAATATTTTCCCTGTT -> GCCATATAAATATTTTCCCTGTTA
GGAAAATTCGGTGTGCTACACCAG -> GAAAATTCGGTGTGCTACACCAGA
TTCAAGTACCAACTGTTTACCGGG -> TCAAGTACCAACTGTTTACCGGGC
CGTAAAAATCGGAACGAGAAGGCT -> GTAAAAATCGGAACGAGAAGGCTA
TACGCCCTGGTCCCTCGAACACGG -> ACGCCCTGGTCCCTCGAACACGGC
ATGCGCGACCGCAAGCGTTGCCAC -> TGCGCGACCGCAAGCGTTGCCACA
GTAAAAATCGGAACGAGAAGGCTA -> TAAAAATCGGAACGAGAAGGCTAG
CTGGCCGCGATACTTCGCGCCAGG -> TGGCCGCGATACTTCGCGCCAGGC
GGGACCGCCTATACTCTGCGTGCG -> GGACCGCCTATACTCTGCGTGCGC
GAAAGACTAGGCGGGTGACATTAC -> AAAGACTAGGCGGGTGACATTACT
GCACACGATATAGCTTATAGCTCA -> CACACGATATAGCTTATAGCTCAC
GAGATATTTATGCTACGCCCTGGT -> AGATATTTATGCTACGCCCTGGTC
GCAAGGTAGAGAGGGTGATGGTGT -> CAAGGTAGAGAGGGTGATGGTGTA
AAAGATCGACGGCTGGGTGACCAA -> AAGATCGACGGCTGGGTGACCAAC
ATCGACGGCTGGGTGACCAACTGG -> TCGACGGCTGGGTGACCAACTGGA
GCCATCCAATCGCTCGCCTGACGG -> CCATCCAATCGCTCGCCTGACGGT
AATATTTTCCCTGTTAGACCTAGC -> ATATTTTCCCTGTTAGACCTAGCA
TGCTCGAATGCGTCTTGAATAGAT -> GCTCGAATGCGTCTTGAATAGATA
AACTGGCCGCGATACTTCGCGCCA -> ACTGGCCGCGATACTTCGCGCCAG
CGCCTAATGTCACGATGTAGGCCA -> GCCTAATGTCACGATGTAGGCCAG
CATGACACCTGTAGCCCGTGGGCC -> ATGACACCTGTAGCCCGTGGGCCA
TTTACCGGGCCAGCGCGGCCATTC -> TTACCGGGCCAGCGCGGCCATTCT
GCGAATCAGGGGCCGGCATAACCA -> CGAATCAGGGGCCGGCATAACCAT
GGATAGCACAGAACATACAGAACT -> GATAGCACAGAACATACAGAACTG
AAAACTATCGTACGTGCCTCGGCC -> AAACTATCGTACGTGCCTCGGCCC
TCTATGGAAACCCTGAATCCGACG -> CTATGGAAACCCTGAATCCGACGG
AGATTAATGGGCGTTCTATGGAAA -> GATTAATGGGCGTTCTATGGAAAG
AATCACCCAAGCATGCAGCGATCC -> ATCACCCAAGCATGCAGCGATCCG
TCTAGAATGCGTCATCATGATTGT -> CTAGAATGCGTCATCATGATTGTG
TAGACCTAGCAAGGAGCACACGAT -> AGACCTAGCAAGGAGCACACGATA
TAGCCCGTGGGCCATCTCTTCTCG -> AGCCCGTGGGCCATCTCTTCTCGC
CGTGAGTCAATGCCTCATTGATGG -> GTGAGTCAATGCCTCATTGATGGT
ACCGAAAACTCGAATCATCCGGTT -> CCGAAAACTCGAATCATCCGGTTT
AACACCTTTTACTCGGAGCGCCGA -> ACACCTTTTACTCGGAGCGCCGAG
CTGCCGTGAGTCAATGCCTCATTG -> TGCCGTGAGTCAATGCCTCATTGA
GCCAGGTCTTTCGACGTATAGTAG -> CCAGGTCTTTCGACGTATAGTAGG
CGCATCTGCTGTTTCCGCTGTGTG -> GCATCTGCTGTTTCCGCTGTGTGA
CTGACGGACTCCTACAGATCCGAT -> TGACGGACTCCTACAGATCCGATT
CAGTCAATTCAGCTGCTCCGAAGG -> AGTCAATTCAGCTGCTCCGAAGGA
GGGTGATGGTGTACATCCGGGTCC -> GGTGATGGTGTACATCCGGGTCCT
TTCTATATCCCGGAGACCATCGCG -> TCTATATCCCGGAGACCATCGCGC
TGGGCCATCTCTTCTCGCAATATC -> GGGCCATCTCTTCTCGCAATATCT
GCCAGCGCGGCCATTCTATTGCAA -> CCAGCGCGGCCATTCTATTGCAAC
CGTCATCATGATTGTGTGCTGTAT -> GTCATCATGATTGTGTGCTGTATA
GCTTAGACGCGCAACGAAAGATCC -> CTTAGACGCGCAACGAAAGATCCA
CAAACACCTTTTACTCGGAGCGCC -> AAACACCTTTTACTCGGAGCGCCG
AATCGGAACGAGAAGGCTAGCTGC -> ATCGGAACGAGAAGGCTAGCTGCA
CTGGCACAAAAAACTATCGTACGT -> TGGCACAAAAAACTATCGTACGTG
GGTCCCTCGAACACGGCTACTTCG -> GTCCCTCGAACACGGCTACTTCGA
GCGTCAAGAGCGTTGTAGGTCATT -> CGTCAAGAGCGTTGTAGGTCATTA
TTTGCACTATTTTATCGCTTCGGG -> TTGCACTATTTTATCGCTTCGGGA
CTTCGGATCATGGTCGGCCGCCAT -> TTCGGATCATGGTCGGCCGCCATC
ACGTGATATATCCGTTTCTTTACT -> CGTGATATATCCGTTTCTTTACTT
CCGGTTACTAAGAATCACCCAAGC -> CGGTTACTAAGAATCACCCAAGCA
AGGTTTTCATTAAACAAACACCTT -> GGTTTTCATTAAACAAACACCTTT
GTATTTGGTTTGCACTATTTTATC -> TATTTGGTTTGCACTATTTTATCG
CGTATAGTAGGGGTACTCGCTAGC -> GTATAGTAGGGGTACTCGCTAGCC
CCAAACGTGATATATCCGTTTCTT -> CAAACGTGATATATCCGTTTCTTT
TGACACCTGTAGCCCGTGGGCCAT -> GACACCTGTAGCCCGTGGGCCATC
ATCAGGCGTTATCCCATAGCCCTT -> TCAGGCGTTATCCCATAGCCCTTG
TAGGTCATTAATAAGGTGACTCTT -> AGGTCATTAATAAGGTGACTCTTA
GCTCACAGATTAATGGGCGTTCTA -> CTCACAGATTAATGGGCGTTCTAT
CCTCGAACACGGCTACTTCGAAAT -> CTCGAACACGGCTACTTCGAAATC
AACGGTCACTTCACGGCCAGCCTT -> ACGGTCACTTCACGGCCAGCCTTT
TAATGTCACGATGTAGGCCAGGAA -> AATGTCACGATGTAGGCCAGGAAA
GGCGCACGCTCTATGGAAACCCTG -> GCGCACGCTCTATGGAAACCCTGA
TGGGACCGCCTATACTCTGCGTGC -> GGGACCGCCTATACTCTGCGTGCG
CATTACCGAAAACTCGAATCATCC -> ATTACCGAAAACTCGAATCATCCG
CGCCAGGTCTTTCGACGTATAGTA -> GCCAGGTCTTTCGACGTATAGTAG
AAACCCTGAATCCGACGGAGGGCG -> AACCCTGAATCCGACGGAGGGCGT
ATCTTACTATTCCTGACGGACTCC -> TCTTACTATTCCTGACGGACTCCT
GGCACAAAAAACTATCGTACGTGC -> GCACAAAAAACTATCGTACGTGCC
CATGGTCGGCCGCCATCCAATCGC -> ATGGTCGGCCGCCATCCAATCGCT
GGTAGTTCTTCTATATCCCGGAGA -> GTAGTTCTTCTATATCCCGGAGAC
TTGGACCCTGATCATTGCTTCTCC -> TGGACCCTGATCATTGCTTCTCCA
GAGTCAATGCCTCATTGATGGTGT -> AGTCAATGCCTCATTGATGGTGTG
CTGGATCCATCGTTCTGAGACTGG -> TGGATCCATCGTTCTGAGACTGGC
AGTACCAACTGTTTACCGGGCCAG -> GTACCAACTGTTTACCGGGCCAGC
GCCTACGCATCTTACTATTCCTGA -> CCTACGCATCTTACTATTCCTGAC
TAATGGGCGTTCTATGGAAAGGTT -> AATGGGCGTTCTATGGAAAGGTTG
GGTTTAATGGCTCGCGCTATACAA -> GTTTAATGGCTCGCGCTATACAAC
ACTATTTTATCGCTTCGGGAGGTA -> CTATTTTATCGCTTCGGGAGGTAC
CTACGCATCTTACTATTCCTGACG -> TACGCATCTTACTATTCCTGACGG
TACCGAAAACTCGAATCATCCGGT -> ACCGAAAACTCGAATCATCCGGTT
ACGCCAGGTCTTTCGACGTATAGT -> CGCCAGGTCTTTCGACGTATAGTA
CACAGTATTGACATGGGGTAGTTC -> ACAGTATTGACATGGGGTAGTTCT
GCCAGGAAAATTCGGTGTGCTACA -> CCAGGAAAATTCGGTGTGCTACAC
TAAAAAGCAAGGTAGAGAGGGTGA -> AAAAAGCAAGGTAGAGAGGGTGAT
GCATACTAGCACTTACACCAGGGG -> CATACTAGCACTTACACCAGGGGC
ACAAACACCTTTTACTCGGAGCGC -> CAAACACCTTTTACTCGGAGCGCC
GGCAGTTCCGAGCCTACGCCAGGT -> GCAGTTCCGAGCCTACGCCAGGTC
GGTGAACTATGACCTAATAGTATA -> GTGAACTATGACCTAATAGTATAA
TTATGTAAAGATCGACGGCTGGGT -> TATGTAAAGATCGACGGCTGGGTG
GCGCAAAATCCCGTTCAATTATGT -> CGCAAAATCCCGTTCAATTATGTA
CAGTAGTAGTGTGTTCTGAGGGTG -> AGTAGTAGTGTGTTCTGAGGGTGA
AGTCTACTGCAAGGGGAGGCAGGC -> GTCTACTGCAAGGGGAGGCAGGCT
GTCTTGAATAGATACAAATCGGTG -> TCTTGAATAGATACAAATCGGTGG
GATACAAATCGGTGGACCAATTCT -> ATACAAATCGGTGGACCAATTCTA
AGCGGTTCACCTGAACGAACGTAC -> GCGGTTCACCTGAACGAACGTACG
CAAGTACCAACTGTTTACCGGGCC -> AAGTACCAACTGTTTACCGGGCCA
GCAATATCTTGGACCCTGATCATT -> CAATATCTTGGACCCTGATCATTG
GGAGGTACACATTACCGAAAACTC -> GAGGTACACATTACCGAAAACTCG
TTTTACCTCGCAATCTAACGGTCA -> TTTACCTCGCAATCTAACGGTCAC
GGTGAGAGACCTGGGACCGCCTAT -> GTGAGAGACCTGGGACCGCCTATA
CTAGAATGCGTCATCATGATTGTG -> TAGAATGCGTCATCATGATTGTGT
CCGCCTATACTCTGCGTGCGCAAG -> CGCCTATACTCTGCGTGCGCAAGT
AACACTAGCGGTTCACCTGAACGA -> ACACTAGCGGTTCACCTGAACGAA
AGAAAGACTAGGCGGGTGACATTA -> GAAAGACTAGGCGGGTGACATTAC
GCTACACCAGAAAGACTAGGCGGG -> CTACACCAGAAAGACTAGGCGGGT
TACGCATCTTACTATTCCTGACGG -> ACGCATCTTACTATTCCTGACGGA
AAAAAACTATCGTACGTGCCTCGG -> AAAAACTATCGTACGTGCCTCGGC
TGTTTCCGCTGTGTGAGACTCGTA -> GTTTCCGCTGTGTGAGACTCGTAA
ACAGAACATACAGAACTGGCCGCG -> CAGAACATACAGAACTGGCCGCGA
CAACTGGATCCATCGTTCTGAGAC -> AACTGGATCCATCGTTCTGAGACT
GGGTTACGCTCTGCGTTCCCACCA -> GGTTACGCTCTGCGTTCCCACCAC
AGACTAGGCGGGTGACATTACTGC -> GACTAGGCGGGTGACATTACTGCC
AACGAAAGATCCAGTCACGTACCG -> ACGAAAGATCCAGTCACGTACCGT
GCTAGCTGCAATCGCGCGTCAAGA -> CTAGCTGCAATCGCGCGTCAAGAG
CCGTACGATGTCAACTGCGTTTTC -> CGTACGATGTCAACTGCGTTTTCG
ATGATTGTGTGCTGTATACAGTCA -> TGATTGTGTGCTGTATACAGTCAA
AGCCTACGCATCTTACTATTCCTG -> GCCTACGCATCTTACTATTCCTGA
ACAGAAAATACCGCCATGCGCGAC -> CAGAAAATACCGCCATGCGCGACC
ACATCTTGACCGGTTACTAAGAAT -> CATCTTGACCGGTTACTAAGAATC
GTGGACCAATTCTAGAATGCGTCA -> TGGACCAATTCTAGAATGCGTCAT
CGACGGCTGGGTGACCAACTGGAT -> GACGGCTGGGTGACCAACTGGATC
ATCATTGCTTCTCCACTAGGTTTT -> TCATTGCTTCTCCACTAGGTTTTC
CTGCAATCGCGCGTCAAGAGCGTT -> TGCAATCGCGCGTCAAGAGCGTTG
CGTTCTGAGACTGGCAACGGCATA -> GTTCTGAGACTGGCAACGGCATAA
CACATTACCGAAAACTCGAATCAT -> ACATTACCGAAAACTCGAATCATC
TGCAACTGGCACGCCGTACGATGT -> GCAACTGGCACGCCGTACGATGTC
TCGCGTAAGGGCACATGCGAGGAG -> CGCGTAAGGGCACATGCGAGGAGA
TCTCGCAATATCTTGGACCCTGAT -> CTCGCAATATCTTGGACCCTGATC
AGCCCTTCGGATCATGGTCGGCCG -> GCCCTTCGGATCATGGTCGGCCGC
CGTAGAAGTAGCTTGGATCGCGTA -> GTAGAAGTAGCTTGGATCGCGTAA
GATAGCACAGAACATACAGAACTG -> ATAGCACAGAACATACAGAACTGG
GGGTATCTCGAGCGTAGAAGTAGC -> GGTATCTCGAGCGTAGAAGTAGCT
CAGGAAAATTCGGTGTGCTACACC -> AGGAAAATTCGGTGTGCTACACCA
AGGTACACATTACCGAAAACTCGA -> GGTACACATTACCGAAAACTCGAA
ATTGTGTGCTGTATACAGTCAATT -> TTGTGTGCTGTATACAGTCAATTC
CGATCGTATTTGGTTTGCACTATT -> GATCGTATTTGGTTTGCACTATTT
TACAGTCAATTCAGCTGCTCCGAA -> ACAGTCAATTCAGCTGCTCCGAAG
CCTATACTCTGCGTGCGCAAGTTA -> CTATACTCTGCGTGCGCAAGTTAG
GACCGCAAGCGTTGCCACACAGTA -> ACCGCAAGCGTTGCCACACAGTAT
TGAGAGACCTGGGACCGCCTATAC -> GAGAGACCTGGGACCGCCTATACT
AACAGAAAATACCGCCATGCGCGA -> ACAGAAAATACCGCCATGCGCGAC
AACCCTGAATCCGACGGAGGGCGT -> ACCCTGAATCCGACGGAGGGCGTA
GTTCCCACCACGTCTTTCAAGTAC -> TTCCCACCACGTCTTTCAAGTACC
CCCGTGGGCCATCTCTTCTCGCAA -> CCGTGGGCCATCTCTTCTCGCAAT
AAAATACCGCCATGCGCGACCGCA -> AAATACCGCCATGCGCGACCGCAA
CCGAAAACTCGAATCATCCGGTTT -> CGAAAACTCGAATCATCCGGTTTA
CGAAAACTCGAATCATCCGGTTTA -> GAAAACTCGAATCATCCGGTTTAA
AATCCCGTTCAATTATGTAAAGAT -> ATCCCGTTCAATTATGTAAAGATC
GCCTAATGTCACGATGTAGGCCAG -> CCTAATGTCACGATGTAGGCCAGG
GCAACGGGTATCTCGAGCGTAGAA -> CAACGGGTATCTCGAGCGTAGAAG
CGGAACGAGAAGGCTAGCTGCAAT -> GGAACGAGAAGGCTAGCTGCAATC
CCATCCAATCGCTCGCCTGACGGT -> CATCCAATCGCTCGCCTGACGGTT
TTCTATGGAAAGGTTGCGTAGTCT -> TCTATGGAAAGGTTGCGTAGTCTA
CAAGGGGAGGCAGGCTTAGACGCG -> AAGGGGAGGCAGGCTTAGACGCGC
CAATGCCTCATTGATGGTGTGGCT -> AATGCCTCATTGATGGTGTGGCTT
GAACTACACGCTGCTCGAATGCGT -> AACTACACGCTGCTCGAATGCGTC
ACTAGCACTTACACCAGGGGCGCA -> CTAGCACTTACACCAGGGGCGCAC
TATCCGTTTCTTTACTTCCGGACA -> ATCCGTTTCTTTACTTCCGGACAC
TACGCTCTGCGTTCCCACCACGTC -> ACGCTCTGCGTTCCCACCACGTCT
GCAACGAAAGATCCAGTCACGTAC -> CAACGAAAGATCCAGTCACGTACC
GCTCCGAAGGAACACTAGCGGTTC -> CTCCGAAGGAACACTAGCGGTTCA
AATGCGTCATCATGATTGTGTGCT -> ATGCGTCATCATGATTGTGTGCTG
GTCACTTCACGGCCAGCCTTTACT -> TCACTTCACGGCCAGCCTTTACTG
CAGCGCGGCCATTCTATTGCAACT -> AGCGCGGCCATTCTATTGCAACTG
TGCGTTCCCACCACGTCTTTCAAG -> GCGTTCCCACCACGTCTTTCAAGT
AGACTCGTAAAAATCGGAACGAGA -> GACTCGTAAAAATCGGAACGAGAA
ACTATGACCTAATAGTATAAGGAA -> CTATGACCTAATAGTATAAGGAAC
AGGGCACATGCGAGGAGATATTTA -> GGGCACATGCGAGGAGATATTTAT
TTTCCCTGTTAGACCTAGCAAGGA -> TTCCCTGTTAGACCTAGCAAGGAG
GCAGTAGTAGTGTGTTCTGAGGGT -> CAGTAGTAGTGTGTTCTGAGGGTG
GATTTTGGGCGGTGGTGAACTATG -> ATTTTGGGCGGTGGTGAACTATGA
CATACTAGCACTTACACCAGGGGC -> ATACTAGCACTTACACCAGGGGCG
GGGTCCTGTGAACGCCTAATGTCA -> GGTCCTGTGAACGCCTAATGTCAC
CATCTGCTGTTTCCGCTGTGTGAG -> ATCTGCTGTTTCCGCTGTGTGAGA
CGCGACCGCAAGCGTTGCCACACA -> GCGACCGCAAGCGTTGCCACACAG
TCGTAAAAATCGGAACGAGAAGGC -> CGTAAAAATCGGAACGAGAAGGCT
TCGCTAGCCCTTCGGATCATGGTC -> CGCTAGCCCTTCGGATCATGGTCG
ATCATCCGGTTTAATGGCTCGCGC -> TCATCCGGTTTAATGGCTCGCGCT
TAACGGTCACTTCACGGCCAGCCT -> AACGGTCACTTCACGGCCAGCCTT
CCAGGCTGTATTTACAGAAAGACC -> CAGGCTGTATTTACAGAAAGACCC
CTATACTCTGCGTGCGCAAGTTAG -> TATACTCTGCGTGCGCAAGTTAGC
TATAGTAGGGGTACTCGCTAGCCC -> ATAGTAGGGGTACTCGCTAGCCCT
CTATCGTACGTGCCTCGGCCCAAA -> TATCGTACGTGCCTCGGCCCAAAC
CCTCGGCCCAAACGTGATATATCC -> CTCGGCCCAAACGTGATATATCCG
CATTTTTACCTCGCAATCTAACGG -> ATTTTTACCTCGCAATCTAACGGT
TTATCGCTTCGGGAGGTACACATT -> TATCGCTTCGGGAGGTACACATTA
CGTGATATATCCGTTTCTTTACTT -> GTGATATATCCGTTTCTTTACTTC
GTCAATTCAGCTGCTCCGAAGGAA -> TCAATTCAGCTGCTCCGAAGGAAC
ATCCGGGTCCTGTGAACGCCTAAT -> TCCGGGTCCTGTGAACGCCTAATG
CACTAGGTTTTCATTAAACAAACA -> ACTAGGTTTTCATTAAACAAACAC
TGACCAACTGGATCCATCGTTCTG -> GACCAACTGGATCCATCGTTCTGA
CTGATCATTGCTTCTCCACTAGGT -> TGATCATTGCTTCTCCACTAGGTT
TACTGCAAGGGGAGGCAGGCTTAG -> ACTGCAAGGGGAGGCAGGCTTAGA
CCAATTCTAGAATGCGTCATCATG -> CAATTCTAGAATGCGTCATCATGA
GTGAACTATGACCTAATAGTATAA -> TGAACTATGACCTAATAGTATAAG
ATTACCGAAAACTCGAATCATCCG -> TTACCGAAAACTCGAATCATCCGG
ACCATTGTTCTTATATCGATCCGG -> CCATTGTTCTTATATCGATCCGGA
TGCAACGGGTATCTCGAGCGTAGA -> GCAACGGGTATCTCGAGCGTAGAA
AATACCGCCATGCGCGACCGCAAG -> ATACCGCCATGCGCGACCGCAAGC
GCACAGAACATACAGAACTGGCCG -> CACAGAACATACAGAACTGGCCGC
CAGATTAATGGGCGTTCTATGGAA -> AGATTAATGGGCGTTCTATGGAAA
AAACTCGAATCATCCGGTTTAATG -> AACTCGAATCATCCGGTTTAATGG
AGTAGCTTGGATCGCGTAAGGGCA -> GTAGCTTGGATCGCGTAAGGGCAC
TAACCATGGCCATATAAATATTTT -> AACCATGGCCATATAAATATTTTC
TGTAAAGATCGACGGCTGGGTGAC -> GTAAAGATCGACGGCTGGGTGACC
AGGGCAGTTCCGAGCCTACGCCAG -> GGGCAGTTCCGAGCCTACGCCAGG
CGCAACGAAAGATCCAGTCACGTA -> GCAACGAAAGATCCAGTCACGTAC
CCTCATTGATGGTGTGGCTTAGTA -> CTCATTGATGGTGTGGCTTAGTAC
GGACCGCCTATACTCTGCGTGCGC -> GACCGCCTATACTCTGCGTGCGCA
CGATCCGGATAGCACAGAACATAC -> GATCCGGATAGCACAGAACATACA
CCATATAAATATTTTCCCTGTTAG -> CATATAAATATTTTCCCTGTTAGA
CAGAACTGGCCGCGATACTTCGCG -> AGAACTGGCCGCGATACTTCGCGC
TGGGCGGTGGTGAACTATGACCTA -> GGGCGGTGGTGAACTATGACCTAA
GCACCCCTATCACGATCGTATTTG -> CACCCCTATCACGATCGTATTTGG
GCATCTTACTATTCCTGACGGACT -> CATCTTACTATTCCTGACGGACTC
TGGCCGCGATACTTCGCGCCAGGC -> GGCCGCGATACTTCGCGCCAGGCT
ACCGGGCCAGCGCGGCCATTCTAT -> CCGGGCCAGCGCGGCCATTCTATT
GGCTCGCGCTATACAACAGAAAAT -> GCTCGCGCTATACAACAGAAAATA
GATGTCAACTGCGTTTTCGTGCAA -> ATGTCAACTGCGTTTTCGTGCAAC
GCATAAAGACGTCCTAACCATGGC -> CATAAAGACGTCCTAACCATGGCC
GTTGCCACACAGTATTGACATGGG -> TTGCCACACAGTATTGACATGGGG
AAAACTCGAATCATCCGGTTTAAT -> AAACTCGAATCATCCGGTTTAATG
CACCCAAGCATGCAGCGATCCGTG -> ACCCAAGCATGCAGCGATCCGTGC
GCGCGTCAAGAGCGTTGTAGGTCA -> CGCGTCAAGAGCGTTGTAGGTCAT
TCCCGGAGACCATCGCGCAAAATC -> CCCGGAGACCATCGCGCAAAATCC
TGGAAAGGTTGCGTAGTCTACTGC -> GGAAAGGTTGCGTAGTCTACTGCA
TCTTTACTTCCGGACACGCGCTCT -> CTTTACTTCCGGACACGCGCTCTC
CAGCGATCCGTGCACCCCTATCAC -> AGCGATCCGTGCACCCCTATCACG
ATTTACAGAAAGACCCAGGGCAGT -> TTTACAGAAAGACCCAGGGCAGTT
CCCTCGAACACGGCTACTTCGAAA -> CCTCGAACACGGCTACTTCGAAAT
ACGATGTCAACTGCGTTTTCGTGC -> CGATGTCAACTGCGTTTTCGTGCA
AAGGGGAGGCAGGCTTAGACGCGC -> AGGGGAGGCAGGCTTAGACGCGCA
GTTCTTATATCGATCCGGATAGCA -> TTCTTATATCGATCCGGATAGCAC
CGCGATACTTCGCGCCAGGCTGTA -> GCGATACTTCGCGCCAGGCTGTAT
GCGATCCGTGCACCCCTATCACGA -> CGATCCGTGCACCCCTATCACGAT
CGAATCAGGGGCCGGCATAACCAT -> GAATCAGGGGCCGGCATAACCATT
CTGCGTGCGCAAGTTAGCCTACGC -> TGCGTGCGCAAGTTAGCCTACGCA
ATGGTGTACATCCGGGTCCTGTGA -> TGGTGTACATCCGGGTCCTGTGAA
ACGTCCTAACCATGGCCATATAAA -> CGTCCTAACCATGGCCATATAAAT
TCTACTGCAAGGGGAGGCAGGCTT -> CTACTGCAAGGGGAGGCAGGCTTA
AGAGACCTGGGACCGCCTATACTC -> GAGACCTGGGACCGCCTATACTCT
TGTCACGATGTAGGCCAGGAAAAT -> GTCACGATGTAGGCCAGGAAAATT
CAACGGGTATCTCGAGCGTAGAAG -> AACGGGTATCTCGAGCGTAGAAGT
ACTGGCCGCGATACTTCGCGCCAG -> CTGGCCGCGATACTTCGCGCCAGG
GAGCCTACGCCAGGTCTTTCGACG -> AGCCTACGCCAGGTCTTTCGACGT
TTCACCTGAACGAACGTACGCATC -> TCACCTGAACGAACGTACGCATCT
GACACCTGTAGCCCGTGGGCCATC -> ACACCTGTAGCCCGTGGGCCATCT
GGCAGGCTTAGACGCGCAACGAAA -> GCAGGCTTAGACGCGCAACGAAAG
AATGTCACGATGTAGGCCAGGAAA -> ATGTCACGATGTAGGCCAGGAAAA
CGCCTATACTCTGCGTGCGCAAGT -> GCCTATACTCTGCGTGCGCAAGTT
TTCTAGAATGCGTCATCATGATTG -> TCTAGAATGCGTCATCATGATTGT
CTTCGCGCCAGGCTGTATTTACAG -> TTCGCGCCAGGCTGTATTTACAGA
GCACTTACACCAGGGGCGCACGCT -> CACTTACACCAGGGGCGCACGCTC
CCCTGATCATTGCTTCTCCACTAG -> CCTGATCATTGCTTCTCCACTAGG
ATGCAGCGATCCGTGCACCCCTAT -> TGCAGCGATCCGTGCACCCCTATC
CACATGCGAGGAGATATTTATGCT -> ACATGCGAGGAGATATTTATGCTA
TTACACCAGGGGCGCACGCTCTAT -> TACACCAGGGGCGCACGCTCTATG
TCCGGACACGCGCTCTCTCGGCAT -> CCGGACACGCGCTCTCTCGGCATA
GGTACACATTACCGAAAACTCGAA -> GTACACATTACCGAAAACTCGAAT
AGTTCTTCTATATCCCGGAGACCA -> GTTCTTCTATATCCCGGAGACCAT
ATACAGTCAATTCAGCTGCTCCGA -> TACAGTCAATTCAGCTGCTCCGAA
CCGTGATCCATGACACCTGTAGCC -> CGTGATCCATGACACCTGTAGCCC
GATGGTGTGGCTTAGTACGCGAGC -> ATGGTGTGGCTTAGTACGCGAGCA
AGCGCCGAGCCTCCTCATCAGGCG -> GCGCCGAGCCTCCTCATCAGGCGT
CCGGCATAACCATTGTTCTTATAT -> CGGCATAACCATTGTTCTTATATC
TCGGTGGACCAATTCTAGAATGCG -> CGGTGGACCAATTCTAGAATGCGT
CGCTCTGCGTTCCCACCACGTCTT -> GCTCTGCGTTCCCACCACGTCTTT
GTGTGCTACACCAGAAAGACTAGG -> TGTGCTACACCAGAAAGACTAGGC
GCCTCATTGATGGTGTGGCTTAGT -> CCTCATTGATGGTGTGGCTTAGTA
AAAATCCCGTTCAATTATGTAAAG -> AAATCCCGTTCAATTATGTAAAGA
GCCATCTCTTCTCGCAATATCTTG -> CCATCTCTTCTCGCAATATCTTGG
TATCTCGAGCGTAGAAGTAGCTTG -> ATCTCGAGCGTAGAAGTAGCTTGG
AACTATGACCTAATAGTATAAGGA -> ACTATGACCTAATAGTATAAGGAA
ATCCCGGAGACCATCGCGCAAAAT -> TCCCGGAGACCATCGCGCAAAATC
CACAGATTAATGGGCGTTCTATGG -> ACAGATTAATGGGCGTTCTATGGA
TTCAGCTGCTCCGAAGGAACACTA -> TCAGCTGCTCCGAAGGAACACTAG
AGGAAAATTCGGTGTGCTACACCA -> GGAAAATTCGGTGTGCTACACCAG
GGCTGGGTGACCAACTGGATCCAT -> GCTGGGTGACCAACTGGATCCATC
CAGAACATACAGAACTGGCCGCGA -> AGAACATACAGAACTGGCCGCGAT
CAGGTCTTTCGACGTATAGTAGGG -> AGGTCTTTCGACGTATAGTAGGGG
CCTCATCAGGCGTTATCCCATAGC -> CTCATCAGGCGTTATCCCATAGCC
AGCACACGATATAGCTTATAGCTC -> GCACACGATATAGCTTATAGCTCA
AGGCGTTATCCCATAGCCCTTGTT -> GGCGTTATCCCATAGCCCTTGTTA
ATGTAAAGATCGACGGCTGGGTGA -> TGTAAAGATCGACGGCTGGGTGAC
CTATATCCCGGAGACCATCGCGCA -> TATATCCCGGAGACCATCGCGCAA
CAGGGCAGTTCCGAGCCTACGCCA -> AGGGCAGTTCCGAGCCTACGCCAG
TTATAGGGTTACGCTCTGCGTTCC -> TATAGGGTTACGCTCTGCGTTCCC
GCGGCCATTCTATTGCAACTGGCA -> CGGCCATTCTATTGCAACTGGCAC
GGTGTGCTACACCAGAAAGACTAG -> GTGTGCTACACCAGAAAGACTAGG
AGCCTCCTCATCAGGCGTTATCCC -> GCCTCCTCATCAGGCGTTATCCCA
TCGCGCCAGGCTGTATTTACAGAA -> CGCGCCAGGCTGTATTTACAGAAA
AGATCGACGGCTGGGTGACCAACT -> GATCGACGGCTGGGTGACCAACTG
GACGGAGGGCGTACATCTTGACCG -> ACGGAGGGCGTACATCTTGACCGG
ACAGTATTGACATGGGGTAGTTCT -> CAGTATTGACATGGGGTAGTTCTT
ATCGTTCTGAGACTGGCAACGGCA -> TCGTTCTGAGACTGGCAACGGCAT
TATAAATATTTTCCCTGTTAGACC -> ATAAATATTTTCCCTGTTAGACCT
CCATTGTTCTTATATCGATCCGGA -> CATTGTTCTTATATCGATCCGGAT
GTTACTAAGAATCACCCAAGCATG -> TTACTAAGAATCACCCAAGCATGC
ATGGTGTGGCTTAGTACGCGAGCA -> TGGTGTGGCTTAGTACGCGAGCAT
TTACTGGCACAAAAAACTATCGTA -> TACTGGCACAAAAAACTATCGTAC
CGGGAGGTACACATTACCGAAAAC -> GGGAGGTACACATTACCGAAAACT
TTGCCACACAGTATTGACATGGGG -> TGCCACACAGTATTGACATGGGGT
TCGCGCAAAATCCCGTTCAATTAT -> CGCGCAAAATCCCGTTCAATTATG
AAATCCGTCGCGAATCAGGGGCCG -> AATCCGTCGCGAATCAGGGGCCGG
TGCTACGCCCTGGTCCCTCGAACA -> GCTACGCCCTGGTCCCTCGAACAC
CTTAGACGCGCAACGAAAGATCCA -> TTAGACGCGCAACGAAAGATCCAG
AGTTCCGAGCCTACGCCAGGTCTT -> GTTCCGAGCCTACGCCAGGTCTTT
TCACGGCCAGCCTTTACTGGCACA -> CACGGCCAGCCTTTACTGGCACAA
CTTTTACTCGGAGCGCCGAGCCTC -> TTTTACTCGGAGCGCCGAGCCTCC
GTTCAATTATGTAAAGATCGACGG -> TTCAATTATGTAAAGATCGACGGC
GCAAGGGGAGGCAGGCTTAGACGC -> CAAGGGGAGGCAGGCTTAGACGCG
CGGCCAGCCTTTACTGGCACAAAA -> GGCCAGCCTTTACTGGCACAAAAA
TTTTATCGCTTCGGGAGGTACACA -> TTTATCGCTTCGGGAGGTACACAT
TAGCAAGGAGCACACGATATAGCT -> AGCAAGGAGCACACGATATAGCTT
AGGAGATATTTATGCTACGCCCTG -> GGAGATATTTATGCTACGCCCTGG
ACACATTACCGAAAACTCGAATCA -> CACATTACCGAAAACTCGAATCAT
ACAGAACTGGCCGCGATACTTCGC -> CAGAACTGGCCGCGATACTTCGCG
AAAGACCCAGGGCAGTTCCGAGCC -> AAGACCCAGGGCAGTTCCGAGCCT
GCTTCGGGAGGTACACATTACCGA -> CTTCGGGAGGTACACATTACCGAA
GGGAGGTACACATTACCGAAAACT -> GGAGGTACACATTACCGAAAACTC
CTCCTCATCAGGCGTTATCCCATA -> TCCTCATCAGGCGTTATCCCATAG
ACGGCTACTTCGAAATCCGTCGCG -> CGGCTACTTCGAAATCCGTCGCGA
CCTAATGTCACGATGTAGGCCAGG -> CTAATGTCACGATGTAGGCCAGGA
CTTCACGGCCAGCCTTTACTGGCA -> TTCACGGCCAGCCTTTACTGGCAC
TCGTATTTGGTTTGCACTATTTTA -> CGTATTTGGTTTGCACTATTTTAT
ACGCTCTGCGTTCCCACCACGTCT -> CGCTCTGCGTTCCCACCACGTCTT
CCTGTAGCCCGTGGGCCATCTCTT -> CTGTAGCCCGTGGGCCATCTCTTC
AATCATCCGGTTTAATGGCTCGCG -> ATCATCCGGTTTAATGGCTCGCGC
GTCTACTGCAAGGGGAGGCAGGCT -> TCTACTGCAAGGGGAGGCAGGCTT
ACGGACTCCTACAGATCCGATTTT -> CGGACTCCTACAGATCCGATTTTG
AACATACAGAACTGGCCGCGATAC -> ACATACAGAACTGGCCGCGATACT
CACGATCGTATTTGGTTTGCACTA -> ACGATCGTATTTGGTTTGCACTAT
ACCATGGCCATATAAATATTTTCC -> CCATGGCCATATAAATATTTTCCC
TATATCCGTTTCTTTACTTCCGGA -> ATATCCGTTTCTTTACTTCCGGAC
ATACTAGCACTTACACCAGGGGCG -> TACTAGCACTTACACCAGGGGCGC
GAGAAGGCTAGCTGCAATCGCGCG -> AGAAGGCTAGCTGCAATCGCGCGT
GTAGTAGTGTGTTCTGAGGGTGAG -> TAGTAGTGTGTTCTGAGGGTGAGA
CGGACTCCTACAGATCCGATTTTG -> GGACTCCTACAGATCCGATTTTGG
CTACGCCAGGTCTTTCGACGTATA -> TACGCCAGGTCTTTCGACGTATAG
TTCGAAATCCGTCGCGAATCAGGG -> TCGAAATCCGTCGCGAATCAGGGG
AGAGGGTGATGGTGTACATCCGGG -> GAGGGTGATGGTGTACATCCGGGT
TATTTATGCTACGCCCTGGTCCCT -> ATTTATGCTACGCCCTGGTCCCTC
TATCCCGGAGACCATCGCGCAAAA -> ATCCCGGAGACCATCGCGCAAAAT
ACTGCAAGGGGAGGCAGGCTTAGA -> CTGCAAGGGGAGGCAGGCTTAGAC
TCACTTCACGGCCAGCCTTTACTG -> CACTTCACGGCCAGCCTTTACTGG
TTTTCATTAAACAAACACCTTTTA -> TTTCATTAAACAAACACCTTTTAC
TCACGATCGTATTTGGTTTGCACT -> CACGATCGTATTTGGTTTGCACTA
CTTAAAAAGCAAGGTAGAGAGGGT -> TTAAAAAGCAAGGTAGAGAGGGTG
CGCTATACAACAGAAAATACCGCC -> GCTATACAACAGAAAATACCGCCA
GGAGCACACGATATAGCTTATAGC -> GAGCACACGATATAGCTTATAGCT
TCAAGTACCAACTGTTTACCGGGC -> CAAGTACCAACTGTTTACCGGGCC
ACCAACTGGATCCATCGTTCTGAG -> CCAACTGGATCCATCGTTCTGAGA
CGCGCTATACAACAGAAAATACCG -> GCGCTATACAACAGAAAATACCGC
CATCGTTCTGAGACTGGCAACGGC -> ATCGTTCTGAGACTGGCAACGGCA
GCTCGCCTGACGGTTCGGCAGTAG -> CTCGCCTGACGGTTCGGCAGTAGT
TGGGTGACCAACTGGATCCATCGT -> GGGTGACCAACTGGATCCATCGTT
CTGGCAACGGCATAAAGACGTCCT -> TGGCAACGGCATAAAGACGTCCTA
TCATTGCTTCTCCACTAGGTTTTC -> CATTGCTTCTCCACTAGGTTTTCA
TCTTGAATAGATACAAATCGGTGG -> CTTGAATAGATACAAATCGGTGGA
TAGGCCAGGAAAATTCGGTGTGCT -> AGGCCAGGAAAATTCGGTGTGCTA
GGGAGGCAGGCTTAGACGCGCAAC -> GGAGGCAGGCTTAGACGCGCAACG
CTGGCACGCCGTACGATGTCAACT -> TGGCACGCCGTACGATGTCAACTG
GGCCAGCCTTTACTGGCACAAAAA -> GCCAGCCTTTACTGGCACAAAAAA
TAGTATAAGGAACTACACGCTGCT -> AGTATAAGGAACTACACGCTGCTC
GGCCATTCTATTGCAACTGGCACG -> GCCATTCTATTGCAACTGGCACGC
ATAAGGAACTACACGCTGCTCGAA -> TAAGGAACTACACGCTGCTCGAAT
CTCGAACACGGCTACTTCGAAATC -> TCGAACACGGCTACTTCGAAATCC
CTGGGTGACCAACTGGATCCATCG -> TGGGTGACCAACTGGATCCATCGT
GTAGGTCATTAATAAGGTGACTCT -> TAGGTCATTAATAAGGTGACTCTT
GCTATACAACAGAAAATACCGCCA -> CTATACAACAGAAAATACCGCCAT
GTGAGACTCGTAAAAATCGGAACG -> TGAGACTCGTAAAAATCGGAACGA
GACCGCCTATACTCTGCGTGCGCA -> ACCGCCTATACTCTGCGTGCGCAA
CGTTGCCACACAGTATTGACATGG -> GTTGCCACACAGTATTGACATGGG
GTTGCGTAGTCTACTGCAAGGGGA -> TTGCGTAGTCTACTGCAAGGGGAG
GACATTACTGCCGTGAGTCAATGC -> ACATTACTGCCGTGAGTCAATGCC
CAAAAAACTATCGTACGTGCCTCG -> AAAAAACTATCGTACGTGCCTCGG
ATAGCTCACAGATTAATGGGCGTT -> TAGCTCACAGATTAATGGGCGTTC
GGTACTCGCTAGCCCTTCGGATCA -> GTACTCGCTAGCCCTTCGGATCAT
TTTCGACGTATAGTAGGGGTACTC -> TTCGACGTATAGTAGGGGTACTCG
GCTGGGTGACCAACTGGATCCATC -> CTGGGTGACCAACTGGATCCATCG
TGCGTGCGCAAGTTAGCCTACGCA -> GCGTGCGCAAGTTAGCCTACGCAT
TTTCAAGTACCAACTGTTTACCGG -> TTCAAGTACCAACTGTTTACCGGG
ACTGGCACAAAAAACTATCGTACG -> CTGGCACAAAAAACTATCGTACGT
AGACTGGCAACGGCATAAAGACGT -> GACTGGCAACGGCATAAAGACGTC
AATCGCTCGCCTGACGGTTCGGCA -> ATCGCTCGCCTGACGGTTCGGCAG
ACGTATAGTAGGGGTACTCGCTAG -> CGTATAGTAGGGGTACTCGCTAGC
GGGTGACCAACTGGATCCATCGTT -> GGTGACCAACTGGATCCATCGTTC
GACGTCCTAACCATGGCCATATAA -> ACGTCCTAACCATGGCCATATAAA
AGGCTAGCTGCAATCGCGCGTCAA -> GGCTAGCTGCAATCGCGCGTCAAG
TCAATTATGTAAAGATCGACGGCT -> CAATTATGTAAAGATCGACGGCTG
GCCTATACTCTGCGTGCGCAAGTT -> CCTATACTCTGCGTGCGCAAGTTA
CCGCTGTGTGAGACTCGTAAAAAT -> CGCTGTGTGAGACTCGTAAAAATC
CTGTATTTACAGAAAGACCCAGGG -> TGTATTTACAGAAAGACCCAGGGC
TCGTACGTGCCTCGGCCCAAACGT -> CGTACGTGCCTCGGCCCAAACGTG
TGGACCAATTCTAGAATGCGTCAT -> GGACCAATTCTAGAATGCGTCATC
GTCATCATGATTGTGTGCTGTATA -> TCATCATGATTGTGTGCTGTATAC
AGAACATACAGAACTGGCCGCGAT -> GAACATACAGAACTGGCCGCGATA
CGGGTGACATTACTGCCGTGAGTC -> GGGTGACATTACTGCCGTGAGTCA
TACACATTACCGAAAACTCGAATC -> ACACATTACCGAAAACTCGAATCA
TGCGTTTTCGTGCAACGGGTATCT -> GCGTTTTCGTGCAACGGGTATCTC
GTGTTCTGAGGGTGAGAGACCTGG -> TGTTCTGAGGGTGAGAGACCTGGG
TACTAGCACTTACACCAGGGGCGC -> ACTAGCACTTACACCAGGGGCGCA
TCTTAAAAAGCAAGGTAGAGAGGG -> CTTAAAAAGCAAGGTAGAGAGGGT
TGACGGACTCCTACAGATCCGATT -> GACGGACTCCTACAGATCCGATTT
TCCAATCGCTCGCCTGACGGTTCG -> CCAATCGCTCGCCTGACGGTTCGG
CTGCGTTTTCGTGCAACGGGTATC -> TGCGTTTTCGTGCAACGGGTATCT
TCCGTCGCGAATCAGGGGCCGGCA -> CCGTCGCGAATCAGGGGCCGGCAT
TGGTTTGCACTATTTTATCGCTTC -> GGTTTGCACTATTTTATCGCTTCG
TTTCCGCTGTGTGAGACTCGTAAA -> TTCCGCTGTGTGAGACTCGTAAAA
CAGAAAGACCCAGGGCAGTTCCGA -> AGAAAGACCCAGGGCAGTTCCGAG
CGTTCAATTATGTAAAGATCGACG -> GTTCAATTATGTAAAGATCGACGG
AGTCAGCTTATAGGGTTACGCTCT -> GTCAGCTTATAGGGTTACGCTCTG
GCGCCGAGCCTCCTCATCAGGCGT -> CGCCGAGCCTCCTCATCAGGCGTT
ACAACAGAAAATACCGCCATGCGC -> CAACAGAAAATACCGCCATGCGCG
GCCAGGCTGTATTTACAGAAAGAC -> CCAGGCTGTATTTACAGAAAGACC
TCCGAGCCTACGCCAGGTCTTTCG -> CCGAGCCTACGCCAGGTCTTTCGA
CAGGGGCGCACGCTCTATGGAAAC -> AGGGGCGCACGCTCTATGGAAACC
GTGTGCTGTATACAGTCAATTCAG -> TGTGCTGTATACAGTCAATTCAGC
GAAATCCGTCGCGAATCAGGGGCC -> AAATCCGTCGCGAATCAGGGGCCG
TATCGCTTCGGGAGGTACACATTA -> ATCGCTTCGGGAGGTACACATTAC
GGGTGAGAGACCTGGGACCGCCTA -> GGTGAGAGACCTGGGACCGCCTAT
GACGGCTGGGTGACCAACTGGATC -> ACGGCTGGGTGACCAACTGGATCC
GGATCATGGTCGGCCGCCATCCAA -> GATCATGGTCGGCCGCCATCCAAT
AAGGAGCACACGATATAGCTTATA -> AGGAGCACACGATATAGCTTATAG
AAAATCGGAACGAGAAGGCTAGCT -> AAATCGGAACGAGAAGGCTAGCTG
TGGTGTACATCCGGGTCCTGTGAA -> GGTGTACATCCGGGTCCTGTGAAC
CCGGGCCAGCGCGGCCATTCTATT -> CGGGCCAGCGCGGCCATTCTATTG
CGCTCTCTCGGCATACTAGCACTT -> GCTCTCTCGGCATACTAGCACTTA
AACACGGCTACTTCGAAATCCGTC -> ACACGGCTACTTCGAAATCCGTCG
ACGGCATAAAGACGTCCTAACCAT -> CGGCATAAAGACGTCCTAACCATG
GCTCTGCGTTCCCACCACGTCTTT -> CTCTGCGTTCCCACCACGTCTTTC
CCAAGCATGCAGCGATCCGTGCAC -> CAAGCATGCAGCGATCCGTGCACC
GGTCACTTCACGGCCAGCCTTTAC -> GTCACTTCACGGCCAGCCTTTACT
GGCATACTAGCACTTACACCAGGG -> GCATACTAGCACTTACACCAGGGG
GCGTACATCTTGACCGGTTACTAA -> CGTACATCTTGACCGGTTACTAAG
ACTACACGCTGCTCGAATGCGTCT -> CTACACGCTGCTCGAATGCGTCTT
TTCCTGACGGACTCCTACAGATCC -> TCCTGACGGACTCCTACAGATCCG
TCGATCCGGATAGCACAGAACATA -> CGATCCGGATAGCACAGAACATAC
AGCCCGTGGGCCATCTCTTCTCGC -> GCCCGTGGGCCATCTCTTCTCGCA
TATTTGGTTTGCACTATTTTATCG -> ATTTGGTTTGCACTATTTTATCGC
CTCTTAAAAAGCAAGGTAGAGAGG -> TCTTAAAAAGCAAGGTAGAGAGGG
GCTCGAATGCGTCTTGAATAGATA -> CTCGAATGCGTCTTGAATAGATAC
GTGTGGCTTAGTACGCGAGCATTT -> TGTGGCTTAGTACGCGAGCATTTT
GTGACCAACTGGATCCATCGTTCT -> TGACCAACTGGATCCATCGTTCTG
CGTCCTAACCATGGCCATATAAAT -> GTCCTAACCATGGCCATATAAATA
CCGTTCAATTATGTAAAGATCGAC -> CGTTCAATTATGTAAAGATCGACG
TGACCTAATAGTATAAGGAACTAC -> GACCTAATAGTATAAGGAACTACA
GAATCAGGGGCCGGCATAACCATT -> AATCAGGGGCCGGCATAACCATTG
TAACCATTGTTCTTATATCGATCC -> AACCATTGTTCTTATATCGATCCG
CACTTACACCAGGGGCGCACGCTC -> ACTTACACCAGGGGCGCACGCTCT
ACTCCTACAGATCCGATTTTGGGC -> CTCCTACAGATCCGATTTTGGGCG
GAATCCGACGGAGGGCGTACATCT -> AATCCGACGGAGGGCGTACATCTT
TCTTGGACCCTGATCATTGCTTCT -> CTTGGACCCTGATCATTGCTTCTC
TATCGTACGTGCCTCGGCCCAAAC -> ATCGTACGTGCCTCGGCCCAAACG
CAAGAGCGTTGTAGGTCATTAATA -> AAGAGCGTTGTAGGTCATTAATAA
GACTAGGCGGGTGACATTACTGCC -> ACTAGGCGGGTGACATTACTGCCG
TAGCTCACAGATTAATGGGCGTTC -> AGCTCACAGATTAATGGGCGTTCT
GAGACCATCGCGCAAAATCCCGTT -> AGACCATCGCGCAAAATCCCGTTC
CATAAAGACGTCCTAACCATGGCC -> ATAAAGACGTCCTAACCATGGCCA
AAGAATCACCCAAGCATGCAGCGA -> AGAATCACCCAAGCATGCAGCGAT
TACTTCCGGACACGCGCTCTCTCG -> ACTTCCGGACACGCGCTCTCTCGG
AGGTCATTAATAAGGTGACTCTTA -> GGTCATTAATAAGGTGACTCTTAA
AGTCAATTCAGCTGCTCCGAAGGA -> GTCAATTCAGCTGCTCCGAAGGAA
TGGTCCCTCGAACACGGCTACTTC -> GGTCCCTCGAACACGGCTACTTCG
CTCTCGGCATACTAGCACTTACAC -> TCTCGGCATACTAGCACTTACACC
TTTGGGCGGTGGTGAACTATGACC -> TTGGGCGGTGGTGAACTATGACCT
AGGAACTACACGCTGCTCGAATGC -> GGAACTACACGCTGCTCGAATGCG
GGTAGAGAGGGTGATGGTGTACAT -> GTAGAGAGGGTGATGGTGTACATC
ATTGCAACTGGCACGCCGTACGAT -> TTGCAACTGGCACGCCGTACGATG
GACGGTTCGGCAGTAGTAGTGTGT -> ACGGTTCGGCAGTAGTAGTGTGTT
ATAACCATTGTTCTTATATCGATC -> TAACCATTGTTCTTATATCGATCC
TGTTCTGAGGGTGAGAGACCTGGG -> GTTCTGAGGGTGAGAGACCTGGGA
CAACGAAAGATCCAGTCACGTACC -> AACGAAAGATCCAGTCACGTACCG
TGTAGGCCAGGAAAATTCGGTGTG -> GTAGGCCAGGAAAATTCGGTGTGC
TGCGCAAGTTAGCCTACGCATCTT -> GCGCAAGTTAGCCTACGCATCTTA
TAGCCCTTCGGATCATGGTCGGCC -> AGCCCTTCGGATCATGGTCGGCCG
CATCGCGCAAAATCCCGTTCAATT -> ATCGCGCAAAATCCCGTTCAATTA
AAGGAACTACACGCTGCTCGAATG -> AGGAACTACACGCTGCTCGAATGC
CGGTGGACCAATTCTAGAATGCGT -> GGTGGACCAATTCTAGAATGCGTC
ATCCAGTCACGTACCGTGATCCAT -> TCCAGTCACGTACCGTGATCCATG
ATAAATATTTTCCCTGTTAGACCT -> TAAATATTTTCCCTGTTAGACCTA
CTGGTCCCTCGAACACGGCTACTT -> TGGTCCCTCGAACACGGCTACTTC
TGCAGCGATCCGTGCACCCCTATC -> GCAGCGATCCGTGCACCCCTATCA
CACGTCTTTCAAGTACCAACTGTT -> ACGTCTTTCAAGTACCAACTGTTT
TTACTAAGAATCACCCAAGCATGC -> TACTAAGAATCACCCAAGCATGCA
AAAGACTAGGCGGGTGACATTACT -> AAGACTAGGCGGGTGACATTACTG
TGGCTCGCGCTATACAACAGAAAA -> GGCTCGCGCTATACAACAGAAAAT
TCGCTTCGGGAGGTACACATTACC -> CGCTTCGGGAGGTACACATTACCG
TTCCGCTGTGTGAGACTCGTAAAA -> TCCGCTGTGTGAGACTCGTAAAAA
CTAGCACTTACACCAGGGGCGCAC -> TAGCACTTACACCAGGGGCGCACG
CAGAAAGACTAGGCGGGTGACATT -> AGAAAGACTAGGCGGGTGACATTA
CCTGAATCCGACGGAGGGCGTACA -> CTGAATCCGACGGAGGGCGTACAT
CGAGCCTACGCCAGGTCTTTCGAC -> GAGCCTACGCCAGGTCTTTCGACG
TCCGTTTCTTTACTTCCGGACACG -> CCGTTTCTTTACTTCCGGACACGC
GGGCCGGCATAACCATTGTTCTTA -> GGCCGGCATAACCATTGTTCTTAT
CGCACGCTCTATGGAAACCCTGAA -> GCACGCTCTATGGAAACCCTGAAT
CTCTGCGTTCCCACCACGTCTTTC -> TCTGCGTTCCCACCACGTCTTTCA
TGCAATCGCGCGTCAAGAGCGTTG -> GCAATCGCGCGTCAAGAGCGTTGT
TTTCTTTACTTCCGGACACGCGCT -> TTCTTTACTTCCGGACACGCGCTC
TTGGGCGGTGGTGAACTATGACCT -> TGGGCGGTGGTGAACTATGACCTA
AGGGGTACTCGCTAGCCCTTCGGA -> GGGGTACTCGCTAGCCCTTCGGAT
ACTGGCACGCCGTACGATGTCAAC -> CTGGCACGCCGTACGATGTCAACT
GCTAGCCCTTCGGATCATGGTCGG -> CTAGCCCTTCGGATCATGGTCGGC
TACGATGTCAACTGCGTTTTCGTG -> ACGATGTCAACTGCGTTTTCGTGC
CCGCCATGCGCGACCGCAAGCGTT -> CGCCATGCGCGACCGCAAGCGTTG
GGTGTACATCCGGGTCCTGTGAAC -> GTGTACATCCGGGTCCTGTGAACG
GATATATCCGTTTCTTTACTTCCG -> ATATATCCGTTTCTTTACTTCCGG
ATCGCTCGCCTGACGGTTCGGCAG -> TCGCTCGCCTGACGGTTCGGCAGT
AGAAAGACCCAGGGCAGTTCCGAG -> GAAAGACCCAGGGCAGTTCCGAGC
CATCTCTTCTCGCAATATCTTGGA -> ATCTCTTCTCGCAATATCTTGGAC
TAGTAGTGTGTTCTGAGGGTGAGA -> AGTAGTGTGTTCTGAGGGTGAGAG
CTCTGCGTGCGCAAGTTAGCCTAC -> TCTGCGTGCGCAAGTTAGCCTACG
GTGAACGCCTAATGTCACGATGTA -> TGAACGCCTAATGTCACGATGTAG
GCGGGTGACATTACTGCCGTGAGT -> CGGGTGACATTACTGCCGTGAGTC
CCAGAAAGACTAGGCGGGTGACAT -> CAGAAAGACTAGGCGGGTGACATT
GTAGAAGTAGCTTGGATCGCGTAA -> TAGAAGTAGCTTGGATCGCGTAAG
CACGCCGTACGATGTCAACTGCGT -> ACGCCGTACGATGTCAACTGCGTT
ATCGCGTAAGGGCACATGCGAGGA -> TCGCGTAAGGGCACATGCGAGGAG
ATATAAATATTTTCCCTGTTAGAC -> TATAAATATTTTCCCTGTTAGACC
GAGACCTGGGACCGCCTATACTCT -> AGACCTGGGACCGCCTATACTCTG
GTTCTTCTATATCCCGGAGACCAT -> TTCTTCTATATCCCGGAGACCATC
ATACAAATCGGTGGACCAATTCTA -> TACAAATCGGTGGACCAATTCTAG
CCATGACACCTGTAGCCCGTGGGC -> CATGACACCTGTAGCCCGTGGGCC
AAAGATCCAGTCACGTACCGTGAT -> AAGATCCAGTCACGTACCGTGATC
TGTGAACGCCTAATGTCACGATGT -> GTGAACGCCTAATGTCACGATGTA
GGGTACTCGCTAGCCCTTCGGATC -> GGTACTCGCTAGCCCTTCGGATCA
CTTATAGGGTTACGCTCTGCGTTC -> TTATAGGGTTACGCTCTGCGTTCC
TCAAGAGCGTTGTAGGTCATTAAT -> CAAGAGCGTTGTAGGTCATTAATA
AGATCCAGTCACGTACCGTGATCC -> GATCCAGTCACGTACCGTGATCCA
AAAGGTTGCGTAGTCTACTGCAAG -> AAGGTTGCGTAGTCTACTGCAAGG
ACGAAAGATCCAGTCACGTACCGT -> CGAAAGATCCAGTCACGTACCGTG
CTCGAATCATCCGGTTTAATGGCT -> TCGAATCATCCGGTTTAATGGCTC
TGTACATCCGGGTCCTGTGAACGC -> GTACATCCGGGTCCTGTGAACGCC
GTCATTAATAAGGTGACTCTTAAA -> TCATTAATAAGGTGACTCTTAAAA
CACGGCTACTTCGAAATCCGTCGC -> ACGGCTACTTCGAAATCCGTCGCG
TTGCAACTGGCACGCCGTACGATG -> TGCAACTGGCACGCCGTACGATGT
TGTAGCCCGTGGGCCATCTCTTCT -> GTAGCCCGTGGGCCATCTCTTCTC
TGTGTGAGACTCGTAAAAATCGGA -> GTGTGAGACTCGTAAAAATCGGAA
TCTGCGTGCGCAAGTTAGCCTACG -> CTGCGTGCGCAAGTTAGCCTACGC
ACTCGTAAAAATCGGAACGAGAAG -> CTCGTAAAAATCGGAACGAGAAGG
CTGTGTGAGACTCGTAAAAATCGG -> TGTGTGAGACTCGTAAAAATCGGA
CGAGGAGATATTTATGCTACGCCC -> GAGGAGATATTTATGCTACGCCCT
ACAGATTAATGGGCGTTCTATGGA -> CAGATTAATGGGCGTTCTATGGAA
TACTCGGAGCGCCGAGCCTCCTCA -> ACTCGGAGCGCCGAGCCTCCTCAT
ATCATGGTCGGCCGCCATCCAATC -> TCATGGTCGGCCGCCATCCAATCG
CCGTGCACCCCTATCACGATCGTA -> CGTGCACCCCTATCACGATCGTAT
TATTGACATGGGGTAGTTCTTCTA -> ATTGACATGGGGTAGTTCTTCTAT
TCGGCCGCCATCCAATCGCTCGCC -> CGGCCGCCATCCAATCGCTCGCCT
TGATGGTGTACATCCGGGTCCTGT -> GATGGTGTACATCCGGGTCCTGTG
GTCCTAACCATGGCCATATAAATA -> TCCTAACCATGGCCATATAAATAT
CTGTGAACGCCTAATGTCACGATG -> TGTGAACGCCTAATGTCACGATGT
GAAGGAACACTAGCGGTTCACCTG -> AAGGAACACTAGCGGTTCACCTGA
CGGCTGGGTGACCAACTGGATCCA -> GGCTGGGTGACCAACTGGATCCAT
TCTGAGACTGGCAACGGCATAAAG -> CTGAGACTGGCAACGGCATAAAGA
ACCAACTGTTTACCGGGCCAGCGC -> CCAACTGTTTACCGGGCCAGCGCG
GGCAACGGCATAAAGACGTCCTAA -> GCAACGGCATAAAGACGTCCTAAC
CGGAGCGCCGAGCCTCCTCATCAG -> GGAGCGCCGAGCCTCCTCATCAGG
AACTCGAATCATCCGGTTTAATGG -> ACTCGAATCATCCGGTTTAATGGC
CCCGTTCAATTATGTAAAGATCGA -> CCGTTCAATTATGTAAAGATCGAC
GCGTTCCCACCACGTCTTTCAAGT -> CGTTCCCACCACGTCTTTCAAGTA
GCGTTATCCCATAGCCCTTGTTAC -> CGTTATCCCATAGCCCTTGTTACG
CCATGCGCGACCGCAAGCGTTGCC -> CATGCGCGACCGCAAGCGTTGCCA
CTATTGCAACTGGCACGCCGTACG -> TATTGCAACTGGCACGCCGTACGA
CTGAGGGTGAGAGACCTGGGACCG -> TGAGGGTGAGAGACCTGGGACCGC
CAGTCACGTACCGTGATCCATGAC -> AGTCACGTACCGTGATCCATGACA
CTCGGCCCAAACGTGATATATCCG -> TCGGCCCAAACGTGATATATCCGT
AATGGCTCGCGCTATACAACAGAA -> ATGGCTCGCGCTATACAACAGAAA
TTTAATGGCTCGCGCTATACAACA -> TTAATGGCTCGCGCTATACAACAG
CTTCTCCACTAGGTTTTCATTAAA -> TTCTCCACTAGGTTTTCATTAAAC
TCCACTAGGTTTTCATTAAACAAA -> CCACTAGGTTTTCATTAAACAAAC
TACATCTTGACCGGTTACTAAGAA -> ACATCTTGACCGGTTACTAAGAAT
CCAACTGGATCCATCGTTCTGAGA -> CAACTGGATCCATCGTTCTGAGAC
TAGCGGTTCACCTGAACGAACGTA -> AGCGGTTCACCTGAACGAACGTAC
ATCCGATTTTGGGCGGTGGTGAAC -> TCCGATTTTGGGCGGTGGTGAACT
TAAAAATCGGAACGAGAAGGCTAG -> AAAAATCGGAACGAGAAGGCTAGC
CAATTCTAGAATGCGTCATCATGA -> AATTCTAGAATGCGTCATCATGAT
AATATCTTGGACCCTGATCATTGC -> ATATCTTGGACCCTGATCATTGCT
ACACAGTATTGACATGGGGTAGTT -> CACAGTATTGACATGGGGTAGTTC
CTTTACTGGCACAAAAAACTATCG -> TTTACTGGCACAAAAAACTATCGT
ACAAATCGGTGGACCAATTCTAGA -> CAAATCGGTGGACCAATTCTAGAA
AGTCACGTACCGTGATCCATGACA -> GTCACGTACCGTGATCCATGACAC
AACTGGCACGCCGTACGATGTCAA -> ACTGGCACGCCGTACGATGTCAAC
ACTAGGTTTTCATTAAACAAACAC -> CTAGGTTTTCATTAAACAAACACC
TTATCCCATAGCCCTTGTTACGCT -> TATCCCATAGCCCTTGTTACGCTA
GCGCAACGAAAGATCCAGTCACGT -> CGCAACGAAAGATCCAGTCACGTA
ACCACGTCTTTCAAGTACCAACTG -> CCACGTCTTTCAAGTACCAACTGT
GGCTGTATTTACAGAAAGACCCAG -> GCTGTATTTACAGAAAGACCCAGG
AGCGTAGAAGTAGCTTGGATCGCG -> GCGTAGAAGTAGCTTGGATCGCGT
ACCGCCTATACTCTGCGTGCGCAA -> CCGCCTATACTCTGCGTGCGCAAG
ATGCGTCATCATGATTGTGTGCTG -> TGCGTCATCATGATTGTGTGCTGT
TCTATATCCCGGAGACCATCGCGC -> CTATATCCCGGAGACCATCGCGCA
TACTAAGAATCACCCAAGCATGCA -> ACTAAGAATCACCCAAGCATGCAG
GTACGTGCCTCGGCCCAAACGTGA -> TACGTGCCTCGGCCCAAACGTGAT
GTCACGATGTAGGCCAGGAAAATT -> TCACGATGTAGGCCAGGAAAATTC
GCAAGGAGCACACGATATAGCTTA -> CAAGGAGCACACGATATAGCTTAT
AAGGAACACTAGCGGTTCACCTGA -> AGGAACACTAGCGGTTCACCTGAA
ACCCAAGCATGCAGCGATCCGTGC -> CCCAAGCATGCAGCGATCCGTGCA
CTATTTTATCGCTTCGGGAGGTAC -> TATTTTATCGCTTCGGGAGGTACA
AAGGCTAGCTGCAATCGCGCGTCA -> AGGCTAGCTGCAATCGCGCGTCAA
CAGCTGCTCCGAAGGAACACTAGC -> AGCTGCTCCGAAGGAACACTAGCG
ATTTTCCCTGTTAGACCTAGCAAG -> TTTTCCCTGTTAGACCTAGCAAGG
ACCGCCATGCGCGACCGCAAGCGT -> CCGCCATGCGCGACCGCAAGCGTT
ATCCGACGGAGGGCGTACATCTTG -> TCCGACGGAGGGCGTACATCTTGA
CTACACGCTGCTCGAATGCGTCTT -> TACACGCTGCTCGAATGCGTCTTG
CGGTGTGCTACACCAGAAAGACTA -> GGTGTGCTACACCAGAAAGACTAG
CGAACGTACGCATCTGCTGTTTCC -> GAACGTACGCATCTGCTGTTTCCG
TACGCGAGCATTTTTACCTCGCAA -> ACGCGAGCATTTTTACCTCGCAAT
GCTACGCCCTGGTCCCTCGAACAC -> CTACGCCCTGGTCCCTCGAACACG
GAGAGACCTGGGACCGCCTATACT -> AGAGACCTGGGACCGCCTATACTC
TCGCAATCTAACGGTCACTTCACG -> CGCAATCTAACGGTCACTTCACGG
TGAGTCAATGCCTCATTGATGGTG -> GAGTCAATGCCTCATTGATGGTGT
TAAAGATCGACGGCTGGGTGACCA -> AAAGATCGACGGCTGGGTGACCAA
ACTTCACGGCCAGCCTTTACTGGC -> CTTCACGGCCAGCCTTTACTGGCA
GGTCATTAATAAGGTGACTCTTAA -> GTCATTAATAAGGTGACTCTTAAA
CTCATCAGGCGTTATCCCATAGCC -> TCATCAGGCGTTATCCCATAGCCC
ACACCTTTTACTCGGAGCGCCGAG -> CACCTTTTACTCGGAGCGCCGAGC
GCGTGCGCAAGTTAGCCTACGCAT -> CGTGCGCAAGTTAGCCTACGCATC
ACCCTGAATCCGACGGAGGGCGTA -> CCCTGAATCCGACGGAGGGCGTAC
CGCCGTACGATGTCAACTGCGTTT -> GCCGTACGATGTCAACTGCGTTTT
GACCTAATAGTATAAGGAACTACA -> ACCTAATAGTATAAGGAACTACAC
AACGAGAAGGCTAGCTGCAATCGC -> ACGAGAAGGCTAGCTGCAATCGCG
AAATATTTTCCCTGTTAGACCTAG -> AATATTTTCCCTGTTAGACCTAGC
ACTGCCGTGAGTCAATGCCTCATT -> CTGCCGTGAGTCAATGCCTCATTG
TCCAGTCACGTACCGTGATCCATG -> CCAGTCACGTACCGTGATCCATGA
TAGGGGTACTCGCTAGCCCTTCGG -> AGGGGTACTCGCTAGCCCTTCGGA
ACCTGAACGAACGTACGCATCTGC -> CCTGAACGAACGTACGCATCTGCT
ACAGTCAATTCAGCTGCTCCGAAG -> CAGTCAATTCAGCTGCTCCGAAGG
GGTTACGCTCTGCGTTCCCACCAC -> GTTACGCTCTGCGTTCCCACCACG
TTGCTTCTCCACTAGGTTTTCATT -> TGCTTCTCCACTAGGTTTTCATTA
